ATAGACCACTA -> TAGACCACTAA
TCTACCACACC -> CTACCACACCC
AAAGTATGTGC -> AAGTATGTGCA
CAGGAGCGGAA -> AGGAGCGGAAA
AACAGTGTTGT -> ACAGTGTTGTG
ATAGAGGCGCC -> TAGAGGCGCCA
GAACGTGAGTT -> AACGTGAGTTG
AACGATCCGTG -> ACGATCCGTGT
TCAACAGCCTT -> CAACAGCCTTC
GCTTCACTCTA -> CTTCACTCTAA
TGATAACGGGG -> GATAACGGGGA
CTTTCTCGAAG -> TTTCTCGAAGC
CAAGCAATTAA -> AAGCAATTAAG
ATAATGCGCGC -> TAATGCGCGCC
TCAAGGTCGCG -> CAAGGTCGCGC
GAAACAGTGTT -> AAACAGTGTTG
TTAGGACCACA -> TAGGACCACAA
TGCCAGACTCC -> GCCAGACTCCC
ACATGGTACCA -> CATGGTACCAC
AGCGGAAAGCA -> GCGGAAAGCAT
AGGGAATGAGA -> GGGAATGAGAA
AGCGTAAGATT -> GCGTAAGATTG
GTCTGCAGCTT -> TCTGCAGCTTC
CCTTTTGTACA -> CTTTTGTACAC
TCGTTGCTTTG -> CGTTGCTTTGT
CAGATCAATGT -> AGATCAATGTG
AATGTGTTAAT -> ATGTGTTAATG
TACAACTTGCC -> ACAACTTGCCG
GTAGGTCTGTG -> TAGGTCTGTGA
CGCTAGATATC -> GCTAGATATCG
GTGAGCATTAC -> TGAGCATTACT
CTTCGCCGGTG -> TTCGCCGGTGG
GGGATGCTCGT -> GGATGCTCGTA
AAGGACGAGGT -> AGGACGAGGTC
CGCACCAATTT -> GCACCAATTTG
GAGGGATGCTC -> AGGGATGCTCG
GACCTATCAAC -> ACCTATCAACA
GGCTAAGCCCC -> GCTAAGCCCCC
GATGATAACGG -> ATGATAACGGG
GTGTCTGTACG -> TGTCTGTACGC
CGCCGGTGGCA -> GCCGGTGGCAT
GTAGAAGTCAG -> TAGAAGTCAGT
TGTCATAATTG -> GTCATAATTGG
TTCTACCACAC -> TCTACCACACC
TGAGTGCGGTG -> GAGTGCGGTGA
CAGGAATAGTT -> AGGAATAGTTT
CGCGTGCCCAA -> GCGTGCCCAAC
TCAAGCTTCGC -> CAAGCTTCGCC
AGCATGGATAA -> GCATGGATAAG
AGTTCCAGATT -> GTTCCAGATTT
GCTGAATTACA -> CTGAATTACAA
GAGTAAGCCAT -> AGTAAGCCATA
GTTGTGTCCTC -> TTGTGTCCTCC
TCGACGACGGT -> CGACGACGGTT
TCTGTCTTGTC -> CTGTCTTGTCC
TTTGCTTAGGC -> TTGCTTAGGCG
GACCCGAGTGA -> ACCCGAGTGAA
TGAAAATTCGC -> GAAAATTCGCG
ACGAACCGCGG -> CGAACCGCGGA
TTCGCGATGAT -> TCGCGATGATA
GATTGTGTATC -> ATTGTGTATCT
CATGAACCACA -> ATGAACCACAA
CCCCAAGTACG -> CCCAAGTACGA
AATACCACACT -> ATACCACACTA
AACGTGAGTTG -> ACGTGAGTTGT
CTGCTCCGGCT -> TGCTCCGGCTC
AACGTCTCTCG -> ACGTCTCTCGC
CAAAGATTGCG -> AAAGATTGCGA
TACTTATCTGT -> ACTTATCTGTG
TCCGACAGGCC -> CCGACAGGCCA
CCTAAGCCTCG -> CTAAGCCTCGC
ACCCATCACCA -> CCCATCACCAG
GTCATAATTGG -> TCATAATTGGT
AGACTCCCTGA -> GACTCCCTGAA
TAAGAGATCTT -> AAGAGATCTTG
AAAGCCGACCA -> AAGCCGACCAC
GCTTCTCTAAA -> CTTCTCTAAAG
AAAGCCGACCC -> AAGCCGACCCT
GACGGTTTGCT -> ACGGTTTGCTT
GTTGCCATATT -> TTGCCATATTA
AACCCTTCTGA -> ACCCTTCTGAT
GGGTTTGGGTT -> GGTTTGGGTTT
AGTCTGAGTAT -> GTCTGAGTATG
CCCGGACACTA -> CCGGACACTAC
TCCTAAATCTT -> CCTAAATCTTG
TGCCACGGATA -> GCCACGGATAA
TCCTTATAACG -> CCTTATAACGC
ATGTGCAAGGA -> TGTGCAAGGAC
CGTCCGGCAGC -> GTCCGGCAGCC
GTAGGCCACAC -> TAGGCCACACC
TTGTCCCAGCA -> TGTCCCAGCAT
ACTCACCAATG -> CTCACCAATGC
TACGATCGCTG -> ACGATCGCTGT
TGACAGCGAGT -> GACAGCGAGTT
GCTCCGGCTCG -> CTCCGGCTCGT
TGCTGCAGGAA -> GCTGCAGGAAC
TCTGATAACAC -> CTGATAACACA
TGAGCCGAATA -> GAGCCGAATAC
GTGCCCAACGA -> TGCCCAACGAT
AGAGCGTAAGA -> GAGCGTAAGAT
AGCGAGTTGTC -> GCGAGTTGTCT
ACTAACCATAT -> CTAACCATATA
GAGGGTTACGA -> AGGGTTACGAC
GTAGGTAGAAG -> TAGGTAGAAGT
GTGTGTAGGTA -> TGTGTAGGTAG
AAGACGATCTT -> AGACGATCTTA
AGAGATCTTGT -> GAGATCTTGTC
ATCTATGCCTT -> TCTATGCCTTG
CTCCCTGAAGT -> TCCCTGAAGTG
TCACGATACCA -> CACGATACCAG
AGAGGGCCGGC -> GAGGGCCGGCA
ATCCAAGTGTG -> TCCAAGTGTGT
AATCTTGACTC -> ATCTTGACTCT
ATACCACACTA -> TACCACACTAT
CGGGTAGGTTT -> GGGTAGGTTTG
AAACTCGCGTC -> AACTCGCGTCT
CGAGCCCACTC -> GAGCCCACTCA
AACTCTATAAA -> ACTCTATAAAA
ATCCTTATAAC -> TCCTTATAACG
TGTGAGCATTA -> GTGAGCATTAC
ACTCTATTCAA -> CTCTATTCAAA
GCAAGGACCCG -> CAAGGACCCGA
TATTCGGTCTT -> ATTCGGTCTTT
TCGCTGTGCTC -> CGCTGTGCTCA
GGATGATTACA -> GATGATTACAG
CGTAAGATTGC -> GTAAGATTGCG
ACAGGCCCTTT -> CAGGCCCTTTT
CATAATTGGTC -> ATAATTGGTCT
GTTTTCAAGAG -> TTTTCAAGAGG
AAGTTCCAGAT -> AGTTCCAGATT
AGTGCGGTGAG -> GTGCGGTGAGC
GCTCGTACGCG -> CTCGTACGCGC
TTAAGCACTAC -> TAAGCACTACG
CGATGATAACG -> GATGATAACGG
CCCGCCCCGCA -> CCGCCCCGCAA
TATCGGTGAGT -> ATCGGTGAGTG
TTGCTGCAGGA -> TGCTGCAGGAA
ACAGTCTGGTA -> CAGTCTGGTAG
GATAAGGGGTT -> ATAAGGGGTTT
TATCAACTCTA -> ATCAACTCTAT
ATCGGTGAGTG -> TCGGTGAGTGC
AGTGAATCCTG -> GTGAATCCTGG
CAGCCTTCGGC -> AGCCTTCGGCG
CACTTACGAAC -> ACTTACGAACC
CTACAGCGAGC -> TACAGCGAGCC
ATTACAACTTG -> TTACAACTTGC
GGGGCCGCGCA -> GGGCCGCGCAC
CCACAGGCCCT -> CACAGGCCCTT
AGGTTTGCTAT -> GGTTTGCTATT
TACGGGCCGAC -> ACGGGCCGACT
ATAACACATGA -> TAACACATGAA
ATAGACTTGTC -> TAGACTTGTCT
TCAGTTGCCAT -> CAGTTGCCATA
AAGAGTTGCTG -> AGAGTTGCTGC
ACTGGAAGGCT -> CTGGAAGGCTA
CTCACCAATGC -> TCACCAATGCC
TAAGCCTCGCT -> AAGCCTCGCTT
TAGCTTCTACG -> AGCTTCTACGA
GTGTCCTCCTA -> TGTCCTCCTAA
TAAAGCTGAAT -> AAAGCTGAATT
TGGCCCCGGAC -> GGCCCCGGACA
AGTACAATCAT -> GTACAATCATA
TAAATCTTGAC -> AAATCTTGACT
GATGATTACAG -> ATGATTACAGC
CTTAGGCGGTT -> TTAGGCGGTTG
ACGACTGTCGA -> CGACTGTCGAG
CACCAGTCACA -> ACCAGTCACAG
CTGTGAGCATT -> TGTGAGCATTA
TGACAGGAATA -> GACAGGAATAG
ACGATAGCTTC -> CGATAGCTTCT
ACCAATGCCAC -> CCAATGCCACG
CGGAACGTGAG -> GGAACGTGAGT
ATATCGGTGAG -> TATCGGTGAGT
GACTCACCAAT -> ACTCACCAATG
CTCCTAAATCT -> TCCTAAATCTT
GATACCAGACA -> ATACCAGACAA
CCCACCGCGCG -> CCACCGCGCGT
AACGCAAAGAT -> ACGCAAAGATT
TGACTCACCAA -> GACTCACCAAT
CTACTACGATA -> TACTACGATAT
GTCAGTTCACT -> TCAGTTCACTT
GACAAGATCAC -> ACAAGATCACC
CAATTAAGCAC -> AATTAAGCACT
TGTGTAGGTAG -> GTGTAGGTAGA
TCTTGTCATAA -> CTTGTCATAAT
ACCATATAGAC -> CCATATAGACC
AGGGTTACGAC -> GGGTTACGACA
TCTCGGAGTGG -> CTCGGAGTGGT
GATAGCTTCTA -> ATAGCTTCTAC
GTAGTACAATC -> TAGTACAATCA
ATTGCGAAGGA -> TTGCGAAGGAA
CTGAGTATGTA -> TGAGTATGTAG
TTCTCTAAAGG -> TCTCTAAAGGA
GCGCACCAATT -> CGCACCAATTT
GTTAACACAAA -> TTAACACAAAA
TGCCGGTCTCG -> GCCGGTCTCGG
TCTGGTAGTGC -> CTGGTAGTGCC
AAGCCGACCCT -> AGCCGACCCTG
CACAATATGAA -> ACAATATGAAA
CTCATAATTTG -> TCATAATTTGC
GGCATTAGGAC -> GCATTAGGACC
TCAGGGTTAGG -> CAGGGTTAGGA
GGTCGCGCGGC -> GTCGCGCGGCT
TTACAGCCTTC -> TACAGCCTTCC
GAGTTGTCTCA -> AGTTGTCTCAG
TCCGGCTCGTG -> CCGGCTCGTGT
ACTCTACACCA -> CTCTACACCAT
CGACTCAAGCT -> GACTCAAGCTT
CAATGACAGCG -> AATGACAGCGA
CGATCGCTGTG -> GATCGCTGTGC
CTTGACTCTCG -> TTGACTCTCGG
GATATCGGTGA -> ATATCGGTGAG
GGTCTCGGAGT -> GTCTCGGAGTG
GACAGCGAGTT -> ACAGCGAGTTG
AAGCATGGATA -> AGCATGGATAA
ATGAGTGTCTG -> TGAGTGTCTGT
ACGATCTTAAG -> CGATCTTAAGG
TGAACGGTCTA -> GAACGGTCTAT
ACAAGTGATGC -> CAAGTGATGCG
GCATAGAGGCG -> CATAGAGGCGC
TTACTAACAAA -> TACTAACAAAG
CGTCTCTCGCC -> GTCTCTCGCCC
TCACGTAGTAC -> CACGTAGTACA
AATATGACCTC -> ATATGACCTCG
GCACTATAGGG -> CACTATAGGGA
GCTACGCGCAC -> CTACGCGCACC
AGACAAGCACC -> GACAAGCACCT
CCGCGCACTTC -> CGCGCACTTCG
AGTATGTGCAA -> GTATGTGCAAG
TTACAGGCGGG -> TACAGGCGGGG
ACGCGCTGTTT -> CGCGCTGTTTT
GCACTACGGGC -> CACTACGGGCC
CAAGATCACCC -> AAGATCACCCG
ACGAGGGTTAC -> CGAGGGTTACG
GATGCGGCACG -> ATGCGGCACGA
TAGATATCGGT -> AGATATCGGTG
CGGCGTTTTTA -> GGCGTTTTTAG
AGGAACATTGT -> GGAACATTGTT
ACGATGACGCC -> CGATGACGCCG
GTCTTCAAAGT -> TCTTCAAAGTG
TTGGTCTCAGT -> TGGTCTCAGTT
CCGTGTCTCTG -> CGTGTCTCTGA
ACAAGATCACC -> CAAGATCACCC
TGGTCGCATGA -> GGTCGCATGAC
GTACGCGCTGT -> TACGCGCTGTT
ACGGGCCGACT -> CGGGCCGACTC
CTATCAACAGC -> TATCAACAGCC
TCTGTGAAGTC -> CTGTGAAGTCG
TGTAACCGCTA -> GTAACCGCTAA
CCGCCCCGCAA -> CGCCCCGCAAC
AAAACCCCAAG -> AAACCCCAAGT
AGTCTGGTAGT -> GTCTGGTAGTG
GATCTTGTCAT -> ATCTTGTCATA
CCGACAGGCCA -> CGACAGGCCAC
GGAACATTGTT -> GAACATTGTTA
GGACCCATCAC -> GACCCATCACC
CCCAACGATCC -> CCAACGATCCG
CGTGAGTTGTA -> GTGAGTTGTAT
ACTCAGAGCTC -> CTCAGAGCTCT
CACTTGTAAGG -> ACTTGTAAGGA
ATAAAAAACCC -> TAAAAAACCCC
GCGCGCCGTAG -> CGCGCCGTAGG
AGCTGCGGAAC -> GCTGCGGAACA
GGCCGCGCACT -> GCCGCGCACTT
TGTGCAAGGAC -> GTGCAAGGACC
GCCCACTCACT -> CCCACTCACTC
GCTTAAAATTT -> CTTAAAATTTA
CATAAGCGACG -> ATAAGCGACGT
AGTGTCTGTAC -> GTGTCTGTACG
TCTAAAGTCGT -> CTAAAGTCGTT
TGACCGCGGAA -> GACCGCGGAAA
ATCTAACGTTC -> TCTAACGTTCC
ACAGGAATAGT -> CAGGAATAGTT
GACTTTCTACT -> ACTTTCTACTA
ATAGTAATACT -> TAGTAATACTC
CGAGGTCTTGA -> GAGGTCTTGAT
CGCTTCTCTAA -> GCTTCTCTAAA
CTACGGGCCGA -> TACGGGCCGAC
CTCTAAAGGAT -> TCTAAAGGATG
TAGTGCCAGAC -> AGTGCCAGACT
CGTTGGGAGCA -> GTTGGGAGCAA
CAGAACTCTAT -> AGAACTCTATA
CTATGAACTCT -> TATGAACTCTA
CATAGAGGCGC -> ATAGAGGCGCC
GTATCCGACAG -> TATCCGACAGG
TGGAAGGCTAA -> GGAAGGCTAAG
GCTCAAGGTCG -> CTCAAGGTCGC
AACCGCTAAGA -> ACCGCTAAGAG
CGTGCCCAACG -> GTGCCCAACGA
AGGGTTAGGAT -> GGGTTAGGATG
TGTGTCCTCCT -> GTGTCCTCCTA
GGAATGAGAAA -> GAATGAGAAAA
GGGTTTGCTAG -> GGTTTGCTAGG
GGAGTGGTACA -> GAGTGGTACAC
GCTATGAACTC -> CTATGAACTCT
TTGAGTGCGGT -> TGAGTGCGGTG
CGAGTTGTCTC -> GAGTTGTCTCA
TGTACACGACT -> GTACACGACTG
TAGTAATACTC -> AGTAATACTCA
TTGCCATATTA -> TGCCATATTAT
CAGTCACAGTA -> AGTCACAGTAT
GGGTTACGACA -> GGTTACGACAA
AGGGGTTTGGG -> GGGGTTTGGGT
AAAACTCGCGT -> AAACTCGCGTC
GAGGCGCCACT -> AGGCGCCACTG
GTCGAGAGCGT -> TCGAGAGCGTA
ACTATAATGTG -> CTATAATGTGG
TATTACGATGA -> ATTACGATGAC
AACGCCTCACT -> ACGCCTCACTA
GACACTACCTC -> ACACTACCTCG
AATGAGAAAAG -> ATGAGAAAAGG
GAGCGTAAGAT -> AGCGTAAGATT
ACCTCGAACGA -> CCTCGAACGAT
AACTTGCCGGT -> ACTTGCCGGTC
AAGGAACATTG -> AGGAACATTGT
TACCAGACAAG -> ACCAGACAAGC
TGAGTTGTATT -> GAGTTGTATTA
CACAGTATAGC -> ACAGTATAGCG
GTGAGCCGAAT -> TGAGCCGAATA
TACGACCTATC -> ACGACCTATCA
TGTGTATCTCA -> GTGTATCTCAT
TCAGGAGCGGA -> CAGGAGCGGAA
GAATACCACAC -> AATACCACACT
TCCTCCTAAAT -> CCTCCTAAATC
TGGGTTTGCTA -> GGGTTTGCTAG
ATGAGAAAAGG -> TGAGAAAAGGT
GTTAATGGCCC -> TTAATGGCCCC
TCTCAGTTGCC -> CTCAGTTGCCA
CTGGAAGGCTA -> TGGAAGGCTAA
AAGCGACGTCC -> AGCGACGTCCG
GTAAGATTGCG -> TAAGATTGCGC
GACAGGAATAG -> ACAGGAATAGT
CTGCGGAACAA -> TGCGGAACAAT
AGAGGGTTATG -> GAGGGTTATGA
GGGAGGGATGC -> GGAGGGATGCT
GTCTCAGGATC -> TCTCAGGATCC
CAGACAAGCAC -> AGACAAGCACC
GCCTAAGCCTC -> CCTAAGCCTCG
TTCAAGAGGCA -> TCAAGAGGCAT
GCATGAGTGTC -> CATGAGTGTCT
AAGTCAGTTCA -> AGTCAGTTCAC
TGTAGGTCACG -> GTAGGTCACGA
CGCCTCACTAG -> GCCTCACTAGG
CACTCACTCAT -> ACTCACTCATA
GAAATATGACC -> AAATATGACCT
TTTTAGGCTAC -> TTTAGGCTACG
ACCCTTCTGAT -> CCCTTCTGATA
CATTGAAGAGG -> ATTGAAGAGGG
GGAATAGTTTC -> GAATAGTTTCA
CAGACTCCCTG -> AGACTCCCTGA
AGGCGCCACTG -> GGCGCCACTGC
GCTCAGGGTTA -> CTCAGGGTTAG
TTGTCATAATT -> TGTCATAATTG
ACCAGACAAGC -> CCAGACAAGCA
AGGAGCGGAAA -> GGAGCGGAAAG
CACGTGCGCAA -> ACGTGCGCAAG
AGGGTTATGAT -> GGGTTATGATT
ACTGCTCCGGC -> CTGCTCCGGCT
TTCACTCTAAA -> TCACTCTAAAG
GTCTATGCGCG -> TCTATGCGCGC
ATCCGACAGGC -> TCCGACAGGCC
ACTACCTCGAA -> CTACCTCGAAC
GGCCACTGGAA -> GCCACTGGAAG
CTCATAGTAAT -> TCATAGTAATA
GGCCGACTCAA -> GCCGACTCAAG
TGCAGCTTCTA -> GCAGCTTCTAC
GGTACACGCTT -> GTACACGCTTC
GCATGGATAAG -> CATGGATAAGG
AAGCCATAGAG -> AGCCATAGAGT
AAAGTCGTTGG -> AAGTCGTTGGG
AAGCTTCGCCG -> AGCTTCGCCGG
TTGTAACGCAA -> TGTAACGCAAA
TCTGCAGCTTC -> CTGCAGCTTCT
GATTTAAAGCT -> ATTTAAAGCTG
CTCAGGGTTAG -> TCAGGGTTAGG
CGACCACAATA -> GACCACAATAT
TTTGCTATTCG -> TTGCTATTCGG
AGACGATCTTA -> GACGATCTTAA
CTTCGACAGTT -> TTCGACAGTTA
GCTTTGTAACC -> CTTTGTAACCG
ACTCTCGGCGA -> CTCTCGGCGAT
GCACGAAGCTA -> CACGAAGCTAT
CTTAAGGACGA -> TTAAGGACGAG
GGCTTATACTT -> GCTTATACTTA
CACCAATTTGT -> ACCAATTTGTC
TATCTGTGAAC -> ATCTGTGAACG
CATGGTACCAC -> ATGGTACCACG
CGGAAAGCATG -> GGAAAGCATGG
CTAACGTTCCC -> TAACGTTCCCG
TAATGGCCCCG -> AATGGCCCCGG
CGATAGCTTCT -> GATAGCTTCTA
GAAGCACTATA -> AAGCACTATAG
ATCAATGTGTT -> TCAATGTGTTA
GACCACAATAT -> ACCACAATATG
TCTCTAAAGGA -> CTCTAAAGGAT
CTTTTGACCGC -> TTTTGACCGCG
GGCGTTTTTAG -> GCGTTTTTAGG
TTAACACAAAA -> TAACACAAAAG
ATATGAAAGAC -> TATGAAAGACG
GTTGTAACGCA -> TTGTAACGCAA
CCGGCAGCCCA -> CGGCAGCCCAC
ACCACGTGCGC -> CCACGTGCGCA
CAAGCACCTAA -> AAGCACCTAAA
CACGAAGCTAT -> ACGAAGCTATG
ACACGACTGTC -> CACGACTGTCG
CCCCCACTTGT -> CCCCACTTGTA
TAGGCGGTTGT -> AGGCGGTTGTA
TGTAACGCAAA -> GTAACGCAAAG
CCACAAGGCTT -> CACAAGGCTTT
GTGTCTCTGAA -> TGTCTCTGAAA
TACCACGTGCG -> ACCACGTGCGC
CTTTCTACTAC -> TTTCTACTACG
TTTTTAGGCTA -> TTTTAGGCTAC
TAAGCGACGTC -> AAGCGACGTCC
AATTTATCTAT -> ATTTATCTATG
ACTGTCGAGAG -> CTGTCGAGAGC
GAGGGTTATGA -> AGGGTTATGAT
CTTGTAAGGAA -> TTGTAAGGAAA
GAACATTGTTA -> AACATTGTTAA
TAGGCCACACC -> AGGCCACACCA
GGTCGCATGAC -> GTCGCATGACT
CCGTACAGAAC -> CGTACAGAACT
ACCCGCTAGAT -> CCCGCTAGATA
TGTCCAGGACC -> GTCCAGGACCC
ACAGCCTTCGG -> CAGCCTTCGGC
CCCGAGTGAAT -> CCGAGTGAATC
AGTAATACTCA -> GTAATACTCAG
CACTTCGTTGC -> ACTTCGTTGCT
CTTGCCGGTCT -> TTGCCGGTCTC
CTTGTCCCAGC -> TTGTCCCAGCA
GTTTGCTAGGG -> TTTGCTAGGGC
CACTCTAAAGT -> ACTCTAAAGTC
CCTAAATCTTG -> CTAAATCTTGA
TTTGCCTAAGC -> TTGCCTAAGCC
CCTTATAACGC -> CTTATAACGCC
TAAGGAAATAT -> AAGGAAATATG
ACACATGAACC -> CACATGAACCA
CTCGGAAGCAC -> TCGGAAGCACT
TTCTACTACGA -> TCTACTACGAT
ACGGGTAGGTT -> CGGGTAGGTTT
AAGACCTACAG -> AGACCTACAGC
CTACGACCTAT -> TACGACCTATC
CACTACGGGCC -> ACTACGGGCCG
CATTAGGACCA -> ATTAGGACCAC
AGATACTATAA -> GATACTATAAT
TCTATGCCTTG -> CTATGCCTTGA
CCAGACTCCCT -> CAGACTCCCTG
GGACAGTCTGG -> GACAGTCTGGT
GGGGCGTTCGT -> GGGCGTTCGTT
TGTCTCAGGAT -> GTCTCAGGATC
AGTGGTCTGCA -> GTGGTCTGCAG
GTTCCAGATTT -> TTCCAGATTTA
TTGGTCGCATG -> TGGTCGCATGA
ACGTAGGCCAC -> CGTAGGCCACA
CTTACGAACCG -> TTACGAACCGC
GCCGACTTGAG -> CCGACTTGAGT
CGGACACTACC -> GGACACTACCT
CTCAGTTGCCA -> TCAGTTGCCAT
ATCGCTGTGCT -> TCGCTGTGCTC
CGGTGAGCATT -> GGTGAGCATTC
CGAAAGTTCCA -> GAAAGTTCCAG
AGGGAGGGATG -> GGGAGGGATGC
GAGTGGTACAC -> AGTGGTACACG
TAACGGGGACA -> AACGGGGACAT
AAGCCGACCAC -> AGCCGACCACA
GATTGATAGAC -> ATTGATAGACT
CACAAGGCTTT -> ACAAGGCTTTC
CTCGCGTCTTC -> TCGCGTCTTCA
GAAGCTATGAA -> AAGCTATGAAC
TCGCATGACTC -> CGCATGACTCA
GGCTCGTGTAG -> GCTCGTGTAGT
GTGGTACACGC -> TGGTACACGCT
ACCCGCCCCGC -> CCCGCCCCGCA
GTCTCGGAGTG -> TCTCGGAGTGG
GAGTGTCTGTA -> AGTGTCTGTAC
ACAGAACTCTA -> CAGAACTCTAT
GATAACGGGGA -> ATAACGGGGAC
CTATTCGGTCT -> TATTCGGTCTT
GATGACGCCGT -> ATGACGCCGTA
GGGTTACTAAC -> GGTTACTAACC
ACAATCATCCA -> CAATCATCCAA
AGATCACCCGC -> GATCACCCGCC
GTATCTCATAA -> TATCTCATAAT
GTCGCATGACT -> TCGCATGACTC
AAGCTATGAAC -> AGCTATGAACT
CTGAATTACAA -> TGAATTACAAC
GGTCTCCTGAG -> GTCTCCTGAGG
CTGTCGAGAGC -> TGTCGAGAGCG
CCATAGAGTCC -> CATAGAGTCCG
CAGCGAGTTGT -> AGCGAGTTGTC
TAATTTGCCTA -> AATTTGCCTAA
CTTCTACGACC -> TTCTACGACCT
GTACACGACTG -> TACACGACTGT
ATGACAGCGAG -> TGACAGCGAGT
CTTCAAAGTGG -> TTCAAAGTGGT
TGACTCTCGGC -> GACTCTCGGCG
CGTTAACACAA -> GTTAACACAAA
TAGGACAGTCT -> AGGACAGTCTG
AGTCGTTGGGA -> GTCGTTGGGAG
AGGTCTGTGAA -> GGTCTGTGAAG
TAGACCACTAA -> AGACCACTAAA
CTGCCTAGATA -> TGCCTAGATAC
CAAGCTTCGCC -> AAGCTTCGCCG
CCGGCTCGTGT -> CGGCTCGTGTA
GTGCTCAGGGT -> TGCTCAGGGTT
ACATGAACCAC -> CATGAACCACA
CTAGTCTGAGT -> TAGTCTGAGTA
GGACACTACCT -> GACACTACCTC
TATAGGGAATG -> ATAGGGAATGA
GTCTGGTAGTG -> TCTGGTAGTGC
GTGGCATGAGT -> TGGCATGAGTG
GGCCGGCATTT -> GCCGGCATTTA
TCGACAGTTAT -> CGACAGTTATC
AACACAAAAGT -> ACACAAAAGTA
CGCTTCACTCT -> GCTTCACTCTA
GGGTAGGTTTG -> GGTAGGTTTGC
CCACGTGCGCA -> CACGTGCGCAA
GAAAATTCGCG -> AAAATTCGCGA
AACAGCCTTCG -> ACAGCCTTCGG
TCTAGGACAGT -> CTAGGACAGTC
GGTTTGGGTTT -> GTTTGGGTTTG
TAAAAAACCCC -> AAAAAACCCCA
ATCATACGATC -> TCATACGATCG
TGTTTTCAAGA -> GTTTTCAAGAG
ACACGCTTCTC -> CACGCTTCTCT
TAACGCAAAGA -> AACGCAAAGAT
CTGAAAACTCG -> TGAAAACTCGC
CTAGGACAGTC -> TAGGACAGTCT
TAGGTAGAAGT -> AGGTAGAAGTC
GGCTTTCTCGA -> GCTTTCTCGAA
CTGTTTTCAAG -> TGTTTTCAAGA
TACCTCGAACG -> ACCTCGAACGA
GGTAGGTTTGC -> GTAGGTTTGCT
TAGAGTCCGCT -> AGAGTCCGCTA
GCCATATTATC -> CCATATTATCA
GTTGCTTTGTA -> TTGCTTTGTAA
CACTAAAGACC -> ACTAAAGACCT
TAGTTTCAGGA -> AGTTTCAGGAG
TGAAGAGTTGC -> GAAGAGTTGCT
AGTTATCACGT -> GTTATCACGTA
CTCGCTTCACT -> TCGCTTCACTC
CATCACCAGAT -> ATCACCAGATC
GTTCGTTAACA -> TTCGTTAACAC
TCTACGACCTA -> CTACGACCTAT
TTACTAACCAT -> TACTAACCATA
GCAGCTTCTAC -> CAGCTTCTACC
ACACCATCTAA -> CACCATCTAAC
GGAACAATTTT -> GAACAATTTTC
TGTGTTAATGG -> GTGTTAATGGC
TTTGGGTTTGC -> TTGGGTTTGCT
CCTTCCCCCAC -> CTTCCCCCACT
CGATGACGCCG -> GATGACGCCGT
GCGTCTTCAAA -> CGTCTTCAAAG
GAGTTGTATTA -> AGTTGTATTAG
AGCAAGAGGGA -> GCAAGAGGGAG
GGATGCTCGTA -> GATGCTCGTAC
CACTGGAAGGC -> ACTGGAAGGCT
CGCCACAGGCC -> GCCACAGGCCC
CAGGGTTAGGA -> AGGGTTAGGAT
AGTACGAGGGT -> GTACGAGGGTT
TACGAGGGTTA -> ACGAGGGTTAC
CACTATCACGG -> ACTATCACGGG
AGTCGCCACAG -> GTCGCCACAGG
ATATAGACCAC -> TATAGACCACT
GAACTCTACAC -> AACTCTACACC
AGGACGAGGTC -> GGACGAGGTCT
TAACCCTTCTG -> AACCCTTCTGA
ACACTCATAGT -> CACTCATAGTA
AAGCACTATAG -> AGCACTATAGG
GCCGTACAGAA -> CCGTACAGAAC
CGGGGCCGCGC -> GGGGCCGCGCA
GGAACACTCAT -> GAACACTCATA
CCTATCAACAG -> CTATCAACAGC
GTGTATCTCAT -> TGTATCTCATA
TACGAACCGCG -> ACGAACCGCGG
ATAATGTGGAC -> TAATGTGGACC
TTTGGTCGCAT -> TTGGTCGCATG
TCATAAGCGAC -> CATAAGCGACG
GGTTGTATCCG -> GTTGTATCCGA
TTAGGCTACGC -> TAGGCTACGCG
GCACTTCGTTG -> CACTTCGTTGC
CGGGGCGTTCG -> GGGGCGTTCGT
TGGATAAGGGG -> GGATAAGGGGT
TAGTCTGAGTA -> AGTCTGAGTAT
ACCTAAAAGAT -> CCTAAAAGATG
GCTTCTACGAC -> CTTCTACGACC
CGAACGATAGC -> GAACGATAGCT
GCTAGTCTGAG -> CTAGTCTGAGT
TTAACAATCAT -> TAACAATCATC
GAACGGTCTAT -> AACGGTCTATG
TAAGCACTACG -> AAGCACTACGG
GGATAAGGGGT -> GATAAGGGGTT
TATGTGCAAGG -> ATGTGCAAGGA
ACGACAAGATC -> CGACAAGATCA
CCACAAGTGAT -> CACAAGTGATG
AGCTGAATTAC -> GCTGAATTACA
ACCACTAAAGA -> CCACTAAAGAC
AAGTGTGTAGG -> AGTGTGTAGGT
TCACTTACGAA -> CACTTACGAAC
TTAGTGGATGA -> TAGTGGATGAT
CTCGGCGATTT -> TCGGCGATTTG
GTGCTCAAGGT -> TGCTCAAGGTC
TACACGACTGT -> ACACGACTGTC
GGCCCCGGACA -> GCCCCGGACAC
AAAGTGGTCTG -> AAGTGGTCTGC
AGTTCACTTCG -> GTTCACTTCGA
GGTGAGTGCTC -> GTGAGTGCTCA
TATGTAGGTCA -> ATGTAGGTCAC
TGAGTATGTAG -> GAGTATGTAGG
GAGTGAATCCT -> AGTGAATCCTG
CCCTGAAGTGA -> CCTGAAGTGAA
GTCTTGTCCCA -> TCTTGTCCCAG
AGAGTTGCTGC -> GAGTTGCTGCA
AGGAAATATGA -> GGAAATATGAC
TTGTAAGGAAA -> TGTAAGGAAAT
GACAAGCACCT -> ACAAGCACCTA
CCACTTGTAAG -> CACTTGTAAGG
TTCTCGAAGCT -> TCTCGAAGCTG
ATACTATAATG -> TACTATAATGT
TACAATCATAC -> ACAATCATACG
CAAAGATTGGA -> AAAGATTGGAC
AAGATCACCCG -> AGATCACCCGC
AACACTCATAG -> ACACTCATAGT
ATAGAGTCCGC -> TAGAGTCCGCT
GCGTGCCCAAC -> CGTGCCCAACG
GCCTTCCCCCA -> CCTTCCCCCAC
CGCGAAAGTTC -> GCGAAAGTTCC
TTAATGGCCCC -> TAATGGCCCCG
TTGGACTTTCT -> TGGACTTTCTA
CAAAGTGGTCT -> AAAGTGGTCTG
CAATTTGTCGA -> AATTTGTCGAC
CTGAAGTGAAG -> TGAAGTGAAGA
TGAAGTGAAGA -> GAAGTGAAGAG
CTCTATTCAAA -> TCTATTCAAAG
CGCAACGTCTC -> GCAACGTCTCT
CAAGGCTTTCT -> AAGGCTTTCTC
TGAATTACAAC -> GAATTACAACT
CTTGAGTTTCT -> TTGAGTTTCTG
ATGGCCCCGGA -> TGGCCCCGGAC
GGGAATGAGAA -> GGAATGAGAAA
CCAACGATCCG -> CAACGATCCGT
CGGGCCGACTC -> GGGCCGACTCA
CACCCGCCCCG -> ACCCGCCCCGC
ATGATTGATAG -> TGATTGATAGA
TGAACCACAAG -> GAACCACAAGT
TATCCGACAGG -> ATCCGACAGGC
GATATTTTAAC -> ATATTTTAACC
CAATCATCCAA -> AATCATCCAAG
TTATAACGCCT -> TATAACGCCTC
CATTACTAACA -> ATTACTAACAA
CTTCTGATAAC -> TTCTGATAACA
GAGCCGAATAC -> AGCCGAATACC
TCCGCTAGTCT -> CCGCTAGTCTG
GACGACGGTTT -> ACGACGGTTTG
GAGTGCGGTGA -> AGTGCGGTGAG
CCGAGTGAATC -> CGAGTGAATCC
CTCAAGCTTCG -> TCAAGCTTCGC
TTCGGCGTTTT -> TCGGCGTTTTT
ATTACTAACAA -> TTACTAACAAA
CCGAATACCAC -> CGAATACCACA
TATGAACTCTA -> ATGAACTCTAC
CGATTTGGTCG -> GATTTGGTCGC
TCAAGAGGGTT -> CAAGAGGGTTA
TTGATAGACTT -> TGATAGACTTG
ACAGGCGGGGC -> CAGGCGGGGCG
GGATCCTTATA -> GATCCTTATAA
TCGGTCTTTTG -> CGGTCTTTTGA
CCTTCCTCACT -> CTTCCTCACTT
TCACCAGATCA -> CACCAGATCAA
CCTTCTGATAA -> CTTCTGATAAC
GCTTATACTTA -> CTTATACTTAT
TTGTAACCGCT -> TGTAACCGCTA
GAAGTCAGTTC -> AAGTCAGTTCA
AGCCTTCGGCG -> GCCTTCGGCGT
CGACGACGGTT -> GACGACGGTTT
GAACAATTTTC -> AACAATTTTCA
CGGATAATGCG -> GGATAATGCGC
AGCACTACGGG -> GCACTACGGGC
TAAGGGGTTTG -> AAGGGGTTTGG
GGTGAGCATTC -> GTGAGCATTCA
ACAATATGAAA -> CAATATGAAAG
TGTAAGGAAAT -> GTAAGGAAATA
GGCACGAAGCT -> GCACGAAGCTA
TTGCTAGGGCT -> TGCTAGGGCTT
GGCCACACCAG -> GCCACACCAGT
AAAGGATGGCA -> AAGGATGGCAT
CTAGGTTGTAT -> TAGGTTGTATC
TATCACGTAGT -> ATCACGTAGTA
AGGGCCGGCAT -> GGGCCGGCATT
TACCACACCCG -> ACCACACCCGC
CACCCGCTAGA -> ACCCGCTAGAT
TACAGGCGGGG -> ACAGGCGGGGC
AGACTTGTCTA -> GACTTGTCTAG
TGAAAGACGAT -> GAAAGACGATC
CGGCAGCCCAC -> GGCAGCCCACC
GCCGGAACGTG -> CCGGAACGTGA
ATTGTGTATCT -> TTGTGTATCTC
GGGTTATGATT -> GGTTATGATTG
AAGAGGGTTAT -> AGAGGGTTATG
CACACCCGCTA -> ACACCCGCTAG
TTGACTGCCTA -> TGACTGCCTAG
AATAGTTTCAG -> ATAGTTTCAGG
AAGTCGTTGGG -> AGTCGTTGGGA
CGTGCGCAAGC -> GTGCGCAAGCA
GTCTTGATTGT -> TCTTGATTGTG
AGGCATTGAAG -> GGCATTGAAGA
GCTATTCGGTC -> CTATTCGGTCT
CGGCTTATACT -> GGCTTATACTT
GCCTCGCTTCA -> CCTCGCTTCAC
GAGTTTCTGTC -> AGTTTCTGTCT
TACGCGCTGTT -> ACGCGCTGTTT
TCTCAGGATCC -> CTCAGGATCCT
CCACGGATAAT -> CACGGATAATG
TACTACGATAT -> ACTACGATATT
TTTCTGTCTTG -> TTCTGTCTTGT
ACGCAAAGATT -> CGCAAAGATTG
GTCCCAGCATA -> TCCCAGCATAG
GCCGCGCACTT -> CCGCGCACTTC
GATGTCCAGGA -> ATGTCCAGGAC
GTACGCCGGAA -> TACGCCGGAAC
AGAGGCATTGA -> GAGGCATTGAA
GACGCCGTACA -> ACGCCGTACAG
AGAGCTCTATT -> GAGCTCTATTA
GTCTAGGACAG -> TCTAGGACAGT
TAGGGCTTAAA -> AGGGCTTAAAA
ATGTGTTAATG -> TGTGTTAATGG
TTGACTCTCGG -> TGACTCTCGGC
TTCGGTCTTTT -> TCGGTCTTTTG
AAAATTTATCT -> AAATTTATCTA
ACCACACCCGC -> CCACACCCGCT
TTCCCGAGTAA -> TCCCGAGTAAG
ACAAGGCTTTC -> CAAGGCTTTCT
ATATTATCAAC -> TATTATCAACT
CGGTCTATGCG -> GGTCTATGCGC
AGCCGACCACA -> GCCGACCACAA
GGGCTTAAAAT -> GGCTTAAAATT
TATAATGTGGA -> ATAATGTGGAC
CGCGGAAAGCC -> GCGGAAAGCCG
GACCCGGGGCC -> ACCCGGGGCCG
GTCCTCCTAAA -> TCCTCCTAAAT
ACCTATCAACA -> CCTATCAACAG
AAGATTGGACT -> AGATTGGACTT
ACCAGTCACAG -> CCAGTCACAGT
TTCTGATAACA -> TCTGATAACAC
AGATTGCGAAG -> GATTGCGAAGG
GGAGGGATGCT -> GAGGGATGCTC
GTGTTGTGTCC -> TGTTGTGTCCT
GTGCCAGACTC -> TGCCAGACTCC
CCGAGTAAGCC -> CGAGTAAGCCA
AACGTTCCCGA -> ACGTTCCCGAG
GTAAGGAAATA -> TAAGGAAATAT
ATGCCACGTAG -> TGCCACGTAGG
CGAATACCACA -> GAATACCACAC
TTCCCCCACTT -> TCCCCCACTTG
GATTGGACTTT -> ATTGGACTTTC
CGTAGGTCTGT -> GTAGGTCTGTG
CGCGCAGGGTT -> GCGCAGGGTTA
AACTCTACACC -> ACTCTACACCA
CTTCGGCGTTT -> TTCGGCGTTTT
ACGATCGCTGT -> CGATCGCTGTG
CATTTAGAAAC -> ATTTAGAAACA
GGCTTAAAATT -> GCTTAAAATTT
GCATTTAGAAA -> CATTTAGAAAC
ATTTGGTCGCA -> TTTGGTCGCAT
GCCCCGCTTAC -> CCCCGCTTACA
TCTTTTGACCG -> CTTTTGACCGC
GATCAATGTGT -> ATCAATGTGTT
CTTAAAATTTA -> TTAAAATTTAT
GCGCGCAGGGT -> CGCGCAGGGTT
CATCTAACGTT -> ATCTAACGTTC
AGAGTCCGCTA -> GAGTCCGCTAG
CCTCACTTACG -> CTCACTTACGA
GCTCTATTACG -> CTCTATTACGA
CACACCAGTCA -> ACACCAGTCAC
AGTGCCACGGA -> GTGCCACGGAT
GAGGGAGGGAT -> AGGGAGGGATG
GAGGCCGACTT -> AGGCCGACTTG
GGTTACTAACC -> GTTACTAACCA
AGCATAGAGGC -> GCATAGAGGCG
ATTGATAGACT -> TTGATAGACTT
GCACCAATTTG -> CACCAATTTGT
GTCCGGCAGCC -> TCCGGCAGCCC
GCTGCGGAACA -> CTGCGGAACAA
CGACTGTCGAG -> GACTGTCGAGA
TAAGATTGCGC -> AAGATTGCGCG
AGCACTATAGG -> GCACTATAGGG
TCATCCAAGTG -> CATCCAAGTGT
AATGGCCCCGG -> ATGGCCCCGGA
AGTTGTATTAG -> GTTGTATTAGT
CATTGTTAACA -> ATTGTTAACAA
ACTCAAGCTTC -> CTCAAGCTTCG
TGTGAACGGTC -> GTGAACGGTCT
GACTCCCTGAA -> ACTCCCTGAAG
TTGTGTCCTCC -> TGTGTCCTCCT
TGCAGGAACAC -> GCAGGAACACT
TATAGCGGTTG -> ATAGCGGTTGA
CGTTCCCGAGT -> GTTCCCGAGTA
TCGCGATGATA -> CGCGATGATAA
ACAATCATACG -> CAATCATACGA
AACGGTCTATG -> ACGGTCTATGC
CTCGAAGCTGC -> TCGAAGCTGCG
GCGCGGCTTAT -> CGCGGCTTATA
CCCGCAACGTC -> CCGCAACGTCT
TGGGAGCAAGA -> GGGAGCAAGAG
ACCACAAGTGA -> CCACAAGTGAT
TAGTACAATCA -> AGTACAATCAT
AGCGACGTCCG -> GCGACGTCCGG
CACGGATAATG -> ACGGATAATGC
CCAATGCCACG -> CAATGCCACGT
GTTTGCTTAGG -> TTTGCTTAGGC
GTTCACTTCGA -> TTCACTTCGAC
CAACTCTATTC -> AACTCTATTCA
CAACTTGCCGG -> AACTTGCCGGT
TAGAGGCGCCA -> AGAGGCGCCAC
TTAGGATGTCC -> TAGGATGTCCA
AAGATTGCGAA -> AGATTGCGAAG
TGTATCCGACA -> GTATCCGACAG
AAAGCATGGAT -> AAGCATGGATA
TGCGAAGGAAC -> GCGAAGGAACA
TGCTAGGGCTT -> GCTAGGGCTTA
AGCTATGAACT -> GCTATGAACTC
ATGACTCACCA -> TGACTCACCAA
CCGACTCAAGC -> CGACTCAAGCT
CGGTTGACTGC -> GGTTGACTGCC
AAACAGTGTTG -> AACAGTGTTGT
TATGAAAGACG -> ATGAAAGACGA
ATCTGTGAACG -> TCTGTGAACGG
CCGCTTACAGG -> CGCTTACAGGC
AATTTGCCTAA -> ATTTGCCTAAG
AGATTTAAAGC -> GATTTAAAGCT
CACGTAGTACA -> ACGTAGTACAA
ACAAGCACCTA -> CAAGCACCTAA
GGTAGAAGTCA -> GTAGAAGTCAG
TAACGTTCCCG -> AACGTTCCCGA
ATGACCTCGGA -> TGACCTCGGAA
GAGTTGCTGCA -> AGTTGCTGCAG
GCCGGTCTCGG -> CCGGTCTCGGA
CTTACAGGCGG -> TTACAGGCGGG
TCCCCCACTTG -> CCCCCACTTGT
AAAGACCTACA -> AAGACCTACAG
AACTCTATTCA -> ACTCTATTCAA
GACAGGCCACT -> ACAGGCCACTG
GCAAGCAATTA -> CAAGCAATTAA
AAGCAATTAAG -> AGCAATTAAGC
ATAGGGAATGA -> TAGGGAATGAG
AGATGAAAATT -> GATGAAAATTC
CCGCGGAAAGC -> CGCGGAAAGCC
TTTGACCGCGG -> TTGACCGCGGA
ACGTCCGGCAG -> CGTCCGGCAGC
TGATTGATAGA -> GATTGATAGAC
TTGTGTATCTC -> TGTGTATCTCA
AAAAGTATGTG -> AAAGTATGTGC
TGCTCAAGGTC -> GCTCAAGGTCG
CTAGATACTAT -> TAGATACTATA
AGGAACACTCA -> GGAACACTCAT
TCGAACGATAG -> CGAACGATAGC
AAGGTGAGCCG -> AGGTGAGCCGA
GATTTGGTCGC -> ATTTGGTCGCA
GTTACTAACCA -> TTACTAACCAT
CATCCAAGTGT -> ATCCAAGTGTG
GACTCTCGGCG -> ACTCTCGGCGA
CCACTAAAGAC -> CACTAAAGACC
AACCACAAGTG -> ACCACAAGTGA
GCGAGCCCACT -> CGAGCCCACTC
TTGTACACGAC -> TGTACACGACT
ATAACGCCTCA -> TAACGCCTCAC
ACCGCGGAAAG -> CCGCGGAAAGC
TCTCCTGAGGT -> CTCCTGAGGTC
CGAGTGAATCC -> GAGTGAATCCT
AGCCTTCCCCC -> GCCTTCCCCCA
GTCTGTACGCC -> TCTGTACGCCG
GAGCATTACTA -> AGCATTACTAA
TCTAAAGGATG -> CTAAAGGATGG
GACGTCCGGCA -> ACGTCCGGCAG
AGCCGAATACC -> GCCGAATACCA
CCCGAGTAAGC -> CCGAGTAAGCC
ATTGGTCTCAG -> TTGGTCTCAGT
AGCCCACTCAC -> GCCCACTCACT
TGAAGAGGGCC -> GAAGAGGGCCG
CACTACCTCGA -> ACTACCTCGAA
TATCTATGCCT -> ATCTATGCCTT
CAGATTTAAAG -> AGATTTAAAGC
GGCCCTTTTGT -> GCCCTTTTGTA
GTCCGCTAGTC -> TCCGCTAGTCT
ATAATTGGTCT -> TAATTGGTCTC
TTACGACAAGA -> TACGACAAGAT
TGAGTTTCTGT -> GAGTTTCTGTC
GGTCTGTGAAG -> GTCTGTGAAGT
GGACGAGGTCT -> GACGAGGTCTT
AGGTCTTGATT -> GGTCTTGATTG
CCGACCCTGAC -> CGACCCTGACA
CAAGGTCGCGC -> AAGGTCGCGCG
TATAAAAAACC -> ATAAAAAACCC
CCAGCATAGAG -> CAGCATAGAGG
ACGAAGCTATG -> CGAAGCTATGA
ACGAGGTCTTG -> CGAGGTCTTGA
CGGTGGCATGA -> GGTGGCATGAG
AGAAAAGGTGA -> GAAAAGGTGAG
TCTACTACGAT -> CTACTACGATA
TGTCTCTGAAA -> GTCTCTGAAAA
CCTCACTAGGT -> CTCACTAGGTT
CGACCTATCAA -> GACCTATCAAC
CAATTTTCAAG -> AATTTTCAAGA
AAAAAACCCCA -> AAAAACCCCAA
TTGCGAAGGAA -> TGCGAAGGAAC
TTCCAGATTTA -> TCCAGATTTAA
CTCATAAGCGA -> TCATAAGCGAC
GGATGGCATTA -> GATGGCATTAG
GACAGTCTGGT -> ACAGTCTGGTA
GAGCCCACTCA -> AGCCCACTCAC
TCCGTGTCTCT -> CCGTGTCTCTG
CCAGATTTAAA -> CAGATTTAAAG
GGTCACGATAC -> GTCACGATACC
GCAACGTCTCT -> CAACGTCTCTC
TGTTAACAATC -> GTTAACAATCA
TACTATAATGT -> ACTATAATGTG
AGGATGTCCAG -> GGATGTCCAGG
GAATCCTGGTC -> AATCCTGGTCT
ACGCTTCTCTA -> CGCTTCTCTAA
AGAACTCTATA -> GAACTCTATAA
CTTGATTGTGT -> TTGATTGTGTA
GAGGTCACTGT -> AGGTCACTGTG
CACTATAGGGA -> ACTATAGGGAA
GTCTCTCGCCC -> TCTCTCGCCCC
TAGTGGATGAT -> AGTGGATGATT
CGCTGTGCTCA -> GCTGTGCTCAA
TTAGGCGGTTG -> TAGGCGGTTGT
TGCTCGTACGC -> GCTCGTACGCG
ACTTGTCTAGG -> CTTGTCTAGGA
AGTCAGTTCAC -> GTCAGTTCACT
GTTGTCTCAGG -> TTGTCTCAGGA
TTTGCTAGGGC -> TTGCTAGGGCT
ATTCAATGACA -> TTCAATGACAG
CGACAAGATCA -> GACAAGATCAC
ATGTCCAGGAC -> TGTCCAGGACC
GTAGTGCCAGA -> TAGTGCCAGAC
ACCTCGGAAGC -> CCTCGGAAGCA
GGGCCGGCATT -> GGCCGGCATTT
AAGTACGAGGG -> AGTACGAGGGT
GACCACTAAAG -> ACCACTAAAGA
GGCATTGAAGA -> GCATTGAAGAG
GCATTAGGACC -> CATTAGGACCA
CCGGGGCCGCG -> CGGGGCCGCGC
AAGTCGCCACA -> AGTCGCCACAG
CTTTTGTACAC -> TTTTGTACACG
CGCCCCGCAAC -> GCCCCGCAACG
ACACCAGTCAC -> CACCAGTCACA
GACTTGTCTAG -> ACTTGTCTAGG
GGTTTGCTAGG -> GTTTGCTAGGG
GTACACGCTTC -> TACACGCTTCT
ACGACCTATCA -> CGACCTATCAA
TGCCTAGATAC -> GCCTAGATACT
GGATAATGCGC -> GATAATGCGCG
CGTTGCTTTGT -> GTTGCTTTGTA
AGGCCCTTTTG -> GGCCCTTTTGT
TCGCCGGTGGC -> CGCCGGTGGCA
CATAGAGTCCG -> ATAGAGTCCGC
TCTTCAAAGTG -> CTTCAAAGTGG
GATTACAGCCT -> ATTACAGCCTT
CATGGATAAGG -> ATGGATAAGGG
GACCGCGGAAA -> ACCGCGGAAAG
TCGCGCGGCTT -> CGCGCGGCTTA
TCGTGTAGTGC -> CGTGTAGTGCC
AAAAGGTGAGC -> AAAGGTGAGCC
CACTAGGTTGT -> ACTAGGTTGTA
CAGGGTTACTA -> AGGGTTACTAA
TGACGCCGTAC -> GACGCCGTACA
TATCTCATAAT -> ATCTCATAATT
TTAGAAACAGT -> TAGAAACAGTG
GTAGGTTTGCT -> TAGGTTTGCTA
TATGCCTTGAG -> ATGCCTTGAGT
CCTCCTAAATC -> CTCCTAAATCT
AGGGCTTAAAA -> GGGCTTAAAAT
GCCACGGATAA -> CCACGGATAAT
GACCACAAGGC -> ACCACAAGGCT
AAAATTCGCGA -> AAATTCGCGAT
GTCGACGACGG -> TCGACGACGGT
TGATTACAGCC -> GATTACAGCCT
TTTCAGGAGCG -> TTCAGGAGCGG
CCATCTAACGT -> CATCTAACGTT
GCGAAGGAACA -> CGAAGGAACAT
GTTTCTGTCTT -> TTTCTGTCTTG
ACAAAGCCGAC -> CAAAGCCGACC
GGTTGACTGCC -> GTTGACTGCCT
CCACTCACTCA -> CACTCACTCAT
TCCGGCAGCCC -> CCGGCAGCCCA
AATACTCAGAG -> ATACTCAGAGC
ACACTACCTCG -> CACTACCTCGA
GGCGGTTGTAA -> GCGGTTGTAAC
TGATGCGGCAC -> GATGCGGCACG
CAGCCCACCGC -> AGCCCACCGCG
GCCATAGAGTC -> CCATAGAGTCC
CCCTTTTGTAC -> CCTTTTGTACA
TTACGATGACG -> TACGATGACGC
TAACAAAGCCG -> AACAAAGCCGA
TTTCTACTACG -> TTCTACTACGA
ACAAAAGTATG -> CAAAAGTATGT
TCTCGCCCCGC -> CTCGCCCCGCT
CCTTGAGTGCG -> CTTGAGTGCGG
ACTTGCCGGTC -> CTTGCCGGTCT
GGAAAGCATGG -> GAAAGCATGGA
GGCGCCACTGC -> GCGCCACTGCT
TTGACCGCGGA -> TGACCGCGGAA
GACCTACAGCG -> ACCTACAGCGA
TGGTAGTGCCA -> GGTAGTGCCAC
AGATCTTGTCA -> GATCTTGTCAT
TACAGCGAGCC -> ACAGCGAGCCC
CAGGCCCTTTT -> AGGCCCTTTTG
AGTGTTGTGTC -> GTGTTGTGTCC
CTTGTCTAGGA -> TTGTCTAGGAC
AAGCCTCGCTT -> AGCCTCGCTTC
ACCTACAGCGA -> CCTACAGCGAG
CGGCATTTAGA -> GGCATTTAGAA
GATCCTTATAA -> ATCCTTATAAC
CGGCTCGTGTA -> GGCTCGTGTAG
AATTAAGCACT -> ATTAAGCACTA
GCATTGAAGAG -> CATTGAAGAGG
TGGTACCACGT -> GGTACCACGTG
GATAGACTTGT -> ATAGACTTGTC
TAGGGAATGAG -> AGGGAATGAGA
GATCGCTGTGC -> ATCGCTGTGCT
ACGGGGACATG -> CGGGGACATGG
GGGCGTTCGTT -> GGCGTTCGTTA
CATTCAATGAC -> ATTCAATGACA
TACAGCCTTCC -> ACAGCCTTCCC
TGCTCAGGGTT -> GCTCAGGGTTA
ATTTTCAAGAG -> TTTTCAAGAGG
ACGCCGGAACG -> CGCCGGAACGT
ATGAAAATTCG -> TGAAAATTCGC
GACTGTCGAGA -> ACTGTCGAGAG
AATGACAGCGA -> ATGACAGCGAG
AGCATTCAATG -> GCATTCAATGA
AGAGGGAGGGA -> GAGGGAGGGAT
GTCTGAGTATG -> TCTGAGTATGT
TTCGCCGGTGG -> TCGCCGGTGGC
GAGCTCTATTA -> AGCTCTATTAC
CGATCCGTGTC -> GATCCGTGTCT
TTAACCCTTCT -> TAACCCTTCTG
CCTCGGAAGCA -> CTCGGAAGCAC
TTTAGAAACAG -> TTAGAAACAGT
CTGCAGCTTCT -> TGCAGCTTCTA
AGGATCCTTAT -> GGATCCTTATA
CTCTCGCCCCG -> TCTCGCCCCGC
CAGGAACACTC -> AGGAACACTCA
AGGTGAGCCGA -> GGTGAGCCGAA
TAACGCCTCAC -> AACGCCTCACT
TCGCCCCGCTT -> CGCCCCGCTTA
CTATTCAAAGA -> TATTCAAAGAT
GATCACCCGCC -> ATCACCCGCCC
GTGGTCTGCAG -> TGGTCTGCAGC
CCCTGACAGGA -> CCTGACAGGAA
ACCACAAGGCT -> CCACAAGGCTT
TTACGAACCGC -> TACGAACCGCG
GTGCAAGGACC -> TGCAAGGACCC
GTCTCCTGAGG -> TCTCCTGAGGT
CACTCATAAGC -> ACTCATAAGCG
TGCGGTGAGCA -> GCGGTGAGCAT
CGGTGAGTGCT -> GGTGAGTGCTC
TACTAACCATA -> ACTAACCATAT
TTCGACAGTTA -> TCGACAGTTAT
CGTAGTACAAT -> GTAGTACAATC
TCCAGATTTAA -> CCAGATTTAAA
TTCAAAGATTG -> TCAAAGATTGG
CACACTATCAC -> ACACTATCACG
TGAGAAAAGGT -> GAGAAAAGGTG
ATCTTGTCATA -> TCTTGTCATAA
AGCGGTTGACT -> GCGGTTGACTG
AGGGATGCTCG -> GGGATGCTCGT
TCAAGAGGCAT -> CAAGAGGCATT
ACTGCCTAGAT -> CTGCCTAGATA
GTCACAGTATA -> TCACAGTATAG
CAACAGCCTTC -> AACAGCCTTCG
TCTATAAAAAA -> CTATAAAAAAC
CACAAGTGATG -> ACAAGTGATGC
GCCGAATACCA -> CCGAATACCAC
AATCCTGGTCT -> ATCCTGGTCTC
GCCGACCCTGA -> CCGACCCTGAC
AGTGGATGATT -> GTGGATGATTA
ACGATATTTTA -> CGATATTTTAA
GCTTACAGGCG -> CTTACAGGCGG
GAACACTCATA -> AACACTCATAG
GGCTACGCGCA -> GCTACGCGCAC
CTATCACGGGT -> TATCACGGGTA
CTCTATAAAAA -> TCTATAAAAAA
CATACGATCGC -> ATACGATCGCT
CAAGGACCCGA -> AAGGACCCGAG
AAAGGTGAGCC -> AAGGTGAGCCG
GTGGACCCATC -> TGGACCCATCA
AAGATTGCGCG -> AGATTGCGCGA
GGTTTGCTATT -> GTTTGCTATTC
TGCTATTCGGT -> GCTATTCGGTC
TGCTTAGGCGG -> GCTTAGGCGGT
ACGTGAGTTGT -> CGTGAGTTGTA
AGCCCACCGCG -> GCCCACCGCGC
ACGTAGTACAA -> CGTAGTACAAT
CCACTGGAAGG -> CACTGGAAGGC
GAATAGTTTCA -> AATAGTTTCAG
TTAAAATTTAT -> TAAAATTTATC
TATTAGTGGAT -> ATTAGTGGATG
GAGCAAGAGGG -> AGCAAGAGGGA
TTGCTTTGTAA -> TGCTTTGTAAC
CGTTTTTAGGC -> GTTTTTAGGCT
CTCTGAAAACT -> TCTGAAAACTC
AGCCGACCCTG -> GCCGACCCTGA
TGCCTTGAGTG -> GCCTTGAGTGC
GTCTGTGAAGT -> TCTGTGAAGTC
TCCTCACTTAC -> CCTCACTTACG
GCATTCAATGA -> CATTCAATGAC
TATTTTAACCC -> ATTTTAACCCT
TAAAGGATGGC -> AAAGGATGGCA
TCGCTTCACTC -> CGCTTCACTCT
AGCTTCGCCGG -> GCTTCGCCGGT
AGGACCCGAGT -> GGACCCGAGTG
CGGCACGAAGC -> GGCACGAAGCT
TATCAACAGCC -> ATCAACAGCCT
TAATGCGCGCC -> AATGCGCGCCG
TGATAGACTTG -> GATAGACTTGT
ATTTAGAAACA -> TTTAGAAACAG
CGTACAGAACT -> GTACAGAACTC
TACGATATTTT -> ACGATATTTTA
CCACTGCTCCG -> CACTGCTCCGG
AGGCGGTTGTA -> GGCGGTTGTAA
GTGTAGGTAGA -> TGTAGGTAGAA
GCGCACTTCGT -> CGCACTTCGTT
TCGGCGATTTG -> CGGCGATTTGG
GGACCACAAGG -> GACCACAAGGC
GAACCGCGGAG -> AACCGCGGAGG
CCTAAAAGATG -> CTAAAAGATGA
GTGCCACGGAT -> TGCCACGGATA
TCATACGATCG -> CATACGATCGC
GCTGTGCTCAA -> CTGTGCTCAAG
CCGGACACTAC -> CGGACACTACC
CAATCATACGA -> AATCATACGAT
AAGAGGCATTG -> AGAGGCATTGA
CCCGGGGCCGC -> CCGGGGCCGCG
GCGCGTGCCCA -> CGCGTGCCCAA
GAGTATGTAGG -> AGTATGTAGGT
TGGACCCATCA -> GGACCCATCAC
GCCAGACTCCC -> CCAGACTCCCT
ATAGTTTCAGG -> TAGTTTCAGGA
GGTTATGATTG -> GTTATGATTGA
GGCGGGGCGTT -> GCGGGGCGTTC
CCTCGCTTCAC -> CTCGCTTCACT
CGTTCGTTAAC -> GTTCGTTAACA
GACCCATCACC -> ACCCATCACCA
CAGTTATCACG -> AGTTATCACGT
CTTCACTCTAA -> TTCACTCTAAA
CGAAGGAACAT -> GAAGGAACATT
ATCCTGGTCTC -> TCCTGGTCTCC
TTTTGACCGCG -> TTTGACCGCGG
CTCACTTACGA -> TCACTTACGAA
TCAGTTCACTT -> CAGTTCACTTC
GCCTTCGGCGT -> CCTTCGGCGTT
AAATTCGCGAT -> AATTCGCGATG
TCAAAGATTGG -> CAAAGATTGGA
TGAAAACTCGC -> GAAAACTCGCG
CGCTAGTCTGA -> GCTAGTCTGAG
TAGTGCCACGG -> AGTGCCACGGA
ACTTACGAACC -> CTTACGAACCG
TCATAGTAATA -> CATAGTAATAC
GAGATCTTGTC -> AGATCTTGTCA
TTCAAAGTGGT -> TCAAAGTGGTC
GCAAAGATTGC -> CAAAGATTGCG
TCTGTGAACGG -> CTGTGAACGGT
CGTCTTCAAAG -> GTCTTCAAAGT
ACAGCGAGCCC -> CAGCGAGCCCA
CGGAGTGGTAC -> GGAGTGGTACA
CTCGTACGCGC -> TCGTACGCGCT
TCCTGAGGTCA -> CCTGAGGTCAC
TTGGGTTTGCT -> TGGGTTTGCTA
TACGCGCACCA -> ACGCGCACCAA
TACTCAGAGCT -> ACTCAGAGCTC
GCGGAAAGCCG -> CGGAAAGCCGA
ACGGTTTGCTT -> CGGTTTGCTTA
CAGCGAGCCCA -> AGCGAGCCCAC
GTTGACTGCCT -> TTGACTGCCTA
CTGTGAAGTCG -> TGTGAAGTCGC
GCAAGAGGGAG -> CAAGAGGGAGG
CTGTCTTGTCC -> TGTCTTGTCCC
ACAACTTGCCG -> CAACTTGCCGG
GCCGGTGGCAT -> CCGGTGGCATG
CTTGTCATAAT -> TTGTCATAATT
AGCACCTAAAA -> GCACCTAAAAG
TTTAACCCTTC -> TTAACCCTTCT
TGCGCGCCGTA -> GCGCGCCGTAG
GTTAGGATGTC -> TTAGGATGTCC
CGAGAGCGTAA -> GAGAGCGTAAG
AAGAGGGAGGG -> AGAGGGAGGGA
CCAAGTACGAG -> CAAGTACGAGG
ACAGTTATCAC -> CAGTTATCACG
CCGTAGGTCTG -> CGTAGGTCTGT
ACACCCGCTAG -> CACCCGCTAGA
CAGCTTCTACC -> AGCTTCTACCA
TATACTTATCT -> ATACTTATCTG
ATTTATCTATG -> TTTATCTATGC
CTTCCCCCACT -> TTCCCCCACTT
ATACTCAGAGC -> TACTCAGAGCT
AGTTTCTGTCT -> GTTTCTGTCTT
GGACCCGGGGC -> GACCCGGGGCC
TCGGAAGCACT -> CGGAAGCACTA
GCCCCGGACAC -> CCCCGGACACT
GAAGAGTTGCT -> AAGAGTTGCTG
TGTGGACCCAT -> GTGGACCCATC
GCTTAGGCGGT -> CTTAGGCGGTT
GCGGTGAGCAT -> CGGTGAGCATT
CTCACTAGGTT -> TCACTAGGTTG
TCGGCGTTTTT -> CGGCGTTTTTA
GGCATTTAGAA -> GCATTTAGAAA
CTTCCTCACTT -> TTCCTCACTTA
TCACGGGTAGG -> CACGGGTAGGT
TCACTCATAAG -> CACTCATAAGC
CCACACCAGTC -> CACACCAGTCA
ATTACAGCCTT -> TTACAGCCTTC
TGAGTGTCTGT -> GAGTGTCTGTA
CAACGATCCGT -> AACGATCCGTG
TTACAACTTGC -> TACAACTTGCC
GATCTTAAGGA -> ATCTTAAGGAC
CAGTGTTGTGT -> AGTGTTGTGTC
GATGCTCGTAC -> ATGCTCGTACG
CGGAACAATTT -> GGAACAATTTT
GTGAACGGTCT -> TGAACGGTCTA
AGGAATAGTTT -> GGAATAGTTTC
TGCGGCACGAA -> GCGGCACGAAG
CCAATTTGTCG -> CAATTTGTCGA
CTACGCGCACC -> TACGCGCACCA
TAACAATCATC -> AACAATCATCC
CAAGAGGCATT -> AAGAGGCATTG
ACTCATAGTAA -> CTCATAGTAAT
GCGTTCGTTAA -> CGTTCGTTAAC
TGTCTAGGACA -> GTCTAGGACAG
TTCTACGACCT -> TCTACGACCTA
TAGGATGTCCA -> AGGATGTCCAG
GAAAGCATGGA -> AAAGCATGGAT
ATGCGCGCCGT -> TGCGCGCCGTA
CCAGTCACAGT -> CAGTCACAGTA
ATGCGCGCAGG -> TGCGCGCAGGG
GAATGAGAAAA -> AATGAGAAAAG
CATAATTTGCC -> ATAATTTGCCT
CTCAGAGCTCT -> TCAGAGCTCTA
TTGTCTCAGGA -> TGTCTCAGGAT
AATCATACGAT -> ATCATACGATC
CTATAAAAAAC -> TATAAAAAACC
CACTGCTCCGG -> ACTGCTCCGGC
AGATCAATGTG -> GATCAATGTGT
AATCATCCAAG -> ATCATCCAAGT
CCGACTTGAGT -> CGACTTGAGTT
GCGCAGGGTTA -> CGCAGGGTTAC
ACTCTATAAAA -> CTCTATAAAAA
GGTTTGCTTAG -> GTTTGCTTAGG
ACTCCCTGAAG -> CTCCCTGAAGT
AGGATGGCATT -> GGATGGCATTA
TTTTAACCCTT -> TTTAACCCTTC
CGCGCGTGCCC -> GCGCGTGCCCA
TTGAAGAGGGC -> TGAAGAGGGCC
ATACGATCGCT -> TACGATCGCTG
TCTTGTCCCAG -> CTTGTCCCAGC
GCGGCACGAAG -> CGGCACGAAGC
ACTTGTAAGGA -> CTTGTAAGGAA
TAATTGGTCTC -> AATTGGTCTCA
GTCTTTTGACC -> TCTTTTGACCG
AGACCTACAGC -> GACCTACAGCG
GCATTACTAAC -> CATTACTAACA
GGTTAGGATGT -> GTTAGGATGTC
GAAGCTGCGGA -> AAGCTGCGGAA
ACGACGGTTTG -> CGACGGTTTGC
TCATAATTGGT -> CATAATTGGTC
AAAAACCCCAA -> AAAACCCCAAG
GATAACACATG -> ATAACACATGA
AGCTCTATTAC -> GCTCTATTACG
TAGGCTACGCG -> AGGCTACGCGC
ATGCCTTGAGT -> TGCCTTGAGTG
TTGATTGTGTA -> TGATTGTGTAT
AGGTCACTGTG -> GGTCACTGTGA
GACGAGGTCTT -> ACGAGGTCTTG
CTGATAACACA -> TGATAACACAT
GGTTGTAACGC -> GTTGTAACGCA
CTGAGGTCACT -> TGAGGTCACTG
ATTAGGACCAC -> TTAGGACCACA
TAGATACTATA -> AGATACTATAA
TGAGCATTCAA -> GAGCATTCAAT
GCGGAACAATT -> CGGAACAATTT
TCTATTACGAT -> CTATTACGATG
CTCTACACCAT -> TCTACACCATC
GTCTCAGTTGC -> TCTCAGTTGCC
GAGTGCTCAGG -> AGTGCTCAGGG
CTATAGGGAAT -> TATAGGGAATG
CTGCAGGAACA -> TGCAGGAACAC
GAGGTCTTGAT -> AGGTCTTGATT
CCCTTCTGATA -> CCTTCTGATAA
GGTCTATGCGC -> GTCTATGCGCG
CCACACCCGCT -> CACACCCGCTA
CACGCTTCTCT -> ACGCTTCTCTA
CAATGTGTTAA -> AATGTGTTAAT
CTGGTCTCCTG -> TGGTCTCCTGA
GACCTCGGAAG -> ACCTCGGAAGC
CAACGTCTCTC -> AACGTCTCTCG
CCATCACCAGA -> CATCACCAGAT
AGGTCGCGCGG -> GGTCGCGCGGC
CAGTTGCCATA -> AGTTGCCATAT
GTCGCGCGGCT -> TCGCGCGGCTT
CGCAAGCAATT -> GCAAGCAATTA
AGCGAGCCCAC -> GCGAGCCCACT
GCGGCTTATAC -> CGGCTTATACT
CAAGAGGGAGG -> AAGAGGGAGGG
TTATCAACTCT -> TATCAACTCTA
CTCAGGATCCT -> TCAGGATCCTT
TTTCAAGAGGC -> TTCAAGAGGCA
TTTCAAGAGGG -> TTCAAGAGGGT
TTTTCAAGAGG -> TTTCAAGAGGG, TTTCAAGAGGC
AGTTGCCATAT -> GTTGCCATATT
ATCTCATAATT -> TCTCATAATTT
AGCTTCTACGA -> GCTTCTACGAC
GACTCAAGCTT -> ACTCAAGCTTC
CAGCCTTCCCC -> AGCCTTCCCCC
AATTACAACTT -> ATTACAACTTG
CCAGATCAATG -> CAGATCAATGT
GGACCCGAGTG -> GACCCGAGTGA
GCGTAAGATTG -> CGTAAGATTGC
GGCGTTCGTTA -> GCGTTCGTTAA
AACACATGAAC -> ACACATGAACC
TCCCGAGTAAG -> CCCGAGTAAGC
ACGATCCGTGT -> CGATCCGTGTC
GTCGCCACAGG -> TCGCCACAGGC
TAATGTGGACC -> AATGTGGACCC
CGCCGGAACGT -> GCCGGAACGTG
AGATTGCGCGA -> GATTGCGCGAA
CGCGCACCAAT -> GCGCACCAATT
GCGATTTGGTC -> CGATTTGGTCG
GGTGAGCCGAA -> GTGAGCCGAAT
CCCGCTTACAG -> CCGCTTACAGG
TCCAGGACCCG -> CCAGGACCCGG
CGGTTGTAACG -> GGTTGTAACGC
CAGCATAGAGG -> AGCATAGAGGC
TGGTCTCAGTT -> GGTCTCAGTTG
ATCACGGGTAG -> TCACGGGTAGG
CGCACTTCGTT -> GCACTTCGTTG
AACAAAGCCGA -> ACAAAGCCGAC
CTTATCTGTGA -> TTATCTGTGAA
GCCTTGAGTGC -> CCTTGAGTGCG
GTCCAGGACCC -> TCCAGGACCCG
AAGGACCCGAG -> AGGACCCGAGT
ACAATTTTCAA -> CAATTTTCAAG
GCGCGAAAGTT -> CGCGAAAGTTC
ATGTAGGTCAC -> TGTAGGTCACG
GGTCTCAGTTG -> GTCTCAGTTGC
AGTTGTCTCAG -> GTTGTCTCAGG
CACCGCGCGTG -> ACCGCGCGTGC
AGTGTGTAGGT -> GTGTGTAGGTA
ACTACGGGCCG -> CTACGGGCCGA
ATAAGGGGTTT -> TAAGGGGTTTG
GTTTGCTATTC -> TTTGCTATTCG
GTAAGCCATAG -> TAAGCCATAGA
GCCGACTCAAG -> CCGACTCAAGC
TATAGACCACT -> ATAGACCACTA
CTTCTACCACA -> TTCTACCACAC
ACAGCGAGTTG -> CAGCGAGTTGT
ACGCCTCACTA -> CGCCTCACTAG
CTATGCGCGCA -> TATGCGCGCAG
ACCCCAAGTAC -> CCCCAAGTACG
AGACCACTAAA -> GACCACTAAAG
GTAGGTCACGA -> TAGGTCACGAT
TCTTGACTCTC -> CTTGACTCTCG
TAACACATGAA -> AACACATGAAC
AAAGCTGAATT -> AAGCTGAATTA
ATGTGGACCCA -> TGTGGACCCAT
CCACGTAGGCC -> CACGTAGGCCA
CACAAAAGTAT -> ACAAAAGTATG
TCGCGTCTTCA -> CGCGTCTTCAA
GCATGACTCAC -> CATGACTCACC
TCACAGTATAG -> CACAGTATAGC
CCGCGGAGGCC -> CGCGGAGGCCG
AACCCCAAGTA -> ACCCCAAGTAC
TTATGATTGAT -> TATGATTGATA
TAACCATATAG -> AACCATATAGA
TTTGTAACCGC -> TTGTAACCGCT
CATAGTAATAC -> ATAGTAATACT
TCAGGATCCTT -> CAGGATCCTTA
CCTGACAGGAA -> CTGACAGGAAT
AATTTGTCGAC -> ATTTGTCGACG
GACATGGTACC -> ACATGGTACCA
GACTGCCTAGA -> ACTGCCTAGAT
TTTCTCGAAGC -> TTCTCGAAGCT
CAGGCGGGGCG -> AGGCGGGGCGT
GGTCACTGTGA -> GTCACTGTGAG
CACGGGTAGGT -> ACGGGTAGGTT
CCCATCACCAG -> CCATCACCAGA
CTTCGTTGCTT -> TTCGTTGCTTT
TTGCCGGTCTC -> TGCCGGTCTCG
CATGAGTGTCT -> ATGAGTGTCTG
CAGAGCTCTAT -> AGAGCTCTATT
ACGTTCCCGAG -> CGTTCCCGAGT
GTATTAGTGGA -> TATTAGTGGAT
CTAAAGGATGG -> TAAAGGATGGC
GAAGTGAAGAG -> AAGTGAAGAGT
GAGGCATTGAA -> AGGCATTGAAG
GCGGTTGTAAC -> CGGTTGTAACG
ATGAAAGACGA -> TGAAAGACGAT
CTGGTAGTGCC -> TGGTAGTGCCA
CGCCGTAGGTC -> GCCGTAGGTCT
TGGCATTAGGA -> GGCATTAGGAC
TCGCCACAGGC -> CGCCACAGGCC
GATTGCGCGAA -> ATTGCGCGAAA
TCTCGAAGCTG -> CTCGAAGCTGC
TCTCTGAAAAC -> CTCTGAAAACT
TGAACTCTACA -> GAACTCTACAC
CGCCCCGCTTA -> GCCCCGCTTAC
GCAGGAACACT -> CAGGAACACTC
GACGATCTTAA -> ACGATCTTAAG
ATTTGTCGACG -> TTTGTCGACGA
GCTAGGGCTTA -> CTAGGGCTTAA
TGATTGTGTAT -> GATTGTGTATC
TTGTCGACGAC -> TGTCGACGACG
ATATGACCTCG -> TATGACCTCGG
TTTGTACACGA -> TTGTACACGAC
TAGAAGTCAGT -> AGAAGTCAGTT
CGCGCACTTCG -> GCGCACTTCGT
GCGGAGGCCGA -> CGGAGGCCGAC
ATCCGTGTCTC -> TCCGTGTCTCT
CTGTGCTCAAG -> TGTGCTCAAGG
GTACAGAACTC -> TACAGAACTCT
ACGGTCTATGC -> CGGTCTATGCG
GCGCTGTTTTC -> CGCTGTTTTCA
ATGCTCGTACG -> TGCTCGTACGC
GGTTACGACAA -> GTTACGACAAG
GGGGTTTGGGT -> GGGTTTGGGTT
GATGGCATTAG -> ATGGCATTAGG
ACACTATCACG -> CACTATCACGG
AATGCGCGCCG -> ATGCGCGCCGT
TCTGAGTATGT -> CTGAGTATGTA
GTTATCACGTA -> TTATCACGTAG
AAGAGATCTTG -> AGAGATCTTGT
GCCACAGGCCC -> CCACAGGCCCT
TAAAGACCTAC -> AAAGACCTACA
AGTTTCAGGAG -> GTTTCAGGAGC
TGTACGCCGGA -> GTACGCCGGAA
GTGAAGTCGCC -> TGAAGTCGCCA
AAGGCTTTCTC -> AGGCTTTCTCG
GAGTCCGCTAG -> AGTCCGCTAGT
ATTCGCGATGA -> TTCGCGATGAT
TCACTTCGACA -> CACTTCGACAG
CCTGGTCTCCT -> CTGGTCTCCTG
CAATGCCACGT -> AATGCCACGTA
GTAACGCAAAG -> TAACGCAAAGA
CTTGAGTGCGG -> TTGAGTGCGGT
GCGCCACTGCT -> CGCCACTGCTC
GAAAAGGTGAG -> AAAAGGTGAGC
CAGGCCACTGG -> AGGCCACTGGA
CGCATGACTCA -> GCATGACTCAC
CCAGACAAGCA -> CAGACAAGCAC
CCTACAGCGAG -> CTACAGCGAGC
TATGATTGATA -> ATGATTGATAG
CTAAGCCTCGC -> TAAGCCTCGCT
TGAGCATTACT -> GAGCATTACTA
AAACCCCAAGT -> AACCCCAAGTA
TGTGAAGTCGC -> GTGAAGTCGCC
GGTGGCATGAG -> GTGGCATGAGT
ACCCGGGGCCG -> CCCGGGGCCGC
ATAATTTGCCT -> TAATTTGCCTA
CTAACAAAGCC -> TAACAAAGCCG
CTCACTCATAA -> TCACTCATAAG
TGTCGACGACG -> GTCGACGACGG
TCGTTAACACA -> CGTTAACACAA
TGTAGGTAGAA -> GTAGGTAGAAG
CGGAAGCACTA -> GGAAGCACTAT
GTATAGCGGTT -> TATAGCGGTTG
GAGCATTCAAT -> AGCATTCAATG
CACCAGATCAA -> ACCAGATCAAT
GCGGAAAGCAT -> CGGAAAGCATG
TGCAAGGACCC -> GCAAGGACCCG
AGTCACAGTAT -> GTCACAGTATA
TCTTGATTGTG -> CTTGATTGTGT
CTGTACGCCGG -> TGTACGCCGGA
ATAGCTTCTAC -> TAGCTTCTACG
TGCGCGCAGGG -> GCGCGCAGGGT
CACATGAACCA -> ACATGAACCAC
CTGACAGGAAT -> TGACAGGAATA
AAAGATTGCGA -> AAGATTGCGAA
TGCTTTGTAAC -> GCTTTGTAACC
CTAAAGACCTA -> TAAAGACCTAC
TAGGTCACGAT -> AGGTCACGATA
AACCGCGGAGG -> ACCGCGGAGGC
CTACGATATTT -> TACGATATTTT
TTCACTTCGAC -> TCACTTCGACA
TTGCCTAAGCC -> TGCCTAAGCCT
CAGGACCCGGG -> AGGACCCGGGG
CGCGTCTTCAA -> GCGTCTTCAAA
CCGGTCTCGGA -> CGGTCTCGGAG
CCCAAGTACGA -> CCAAGTACGAG
TGAAGTCGCCA -> GAAGTCGCCAC
GACCCTGACAG -> ACCCTGACAGG
GTTGTATCCGA -> TTGTATCCGAC
TACCACACTAT -> ACCACACTATC
TAAAAGATGAA -> AAAAGATGAAA
TACAGAACTCT -> ACAGAACTCTA
AATTTTCAAGA -> ATTTTCAAGAG
GCCACTGCTCC -> CCACTGCTCCG
AAGTATGTGCA -> AGTATGTGCAA
TACGACAAGAT -> ACGACAAGATC
GAAGGAACATT -> AAGGAACATTG
GTCGTTGGGAG -> TCGTTGGGAGC
TCACTGTGAGC -> CACTGTGAGCA
TTTGTCGACGA -> TTGTCGACGAC
CTAAAAGATGA -> TAAAAGATGAA
AGGTAGAAGTC -> GGTAGAAGTCA
AAGAGGGCCGG -> AGAGGGCCGGC
TATGACCTCGG -> ATGACCTCGGA
AGTGATGCGGC -> GTGATGCGGCA
CTAGATATCGG -> TAGATATCGGT
GAAGAGGGCCG -> AAGAGGGCCGG
AGCCATAGAGT -> GCCATAGAGTC
CCGCAACGTCT -> CGCAACGTCTC
TCGGTGAGTGC -> CGGTGAGTGCT
GGAAAGCCGAC -> GAAAGCCGACC
ACTTCGTTGCT -> CTTCGTTGCTT
AAAGATGAAAA -> AAGATGAAAAT
GGCGATTTGGT -> GCGATTTGGTC
ACACAAAAGTA -> CACAAAAGTAT
TTGCTTAGGCG -> TGCTTAGGCGG
AAAAGATGAAA -> AAAGATGAAAA
TACGCCGGAAC -> ACGCCGGAACG
CGTGTAGTGCC -> GTGTAGTGCCA
AGTCCGCTAGT -> GTCCGCTAGTC
CGGTTTGCTTA -> GGTTTGCTTAG
TAGCGGTTGAC -> AGCGGTTGACT
CCCCACTTGTA -> CCCACTTGTAA
ATGGCATTAGG -> TGGCATTAGGA
TTCCTCACTTA -> TCCTCACTTAC
GAAGGCTAAGC -> AAGGCTAAGCC
CGCCACTGCTC -> GCCACTGCTCC
GTAGTGCCACG -> TAGTGCCACGG
AAGTGGTCTGC -> AGTGGTCTGCA
TAAGCCATAGA -> AAGCCATAGAG
GGAAGCACTAT -> GAAGCACTATA
GCCCTTTTGTA -> CCCTTTTGTAC
AGGTCACGATA -> GGTCACGATAC
GGTAGTGCCAC -> GTAGTGCCACG
ACGTGCGCAAG -> CGTGCGCAAGC
ACCCGAGTGAA -> CCCGAGTGAAT
ATCACCCGCCC -> TCACCCGCCCC
ATTGCGCGAAA -> TTGCGCGAAAG
AGTGCCAGACT -> GTGCCAGACTC
CGTGTCTCTGA -> GTGTCTCTGAA
TCCAAGTGTGT -> CCAAGTGTGTA
CCTGAAGTGAA -> CTGAAGTGAAG
TAAAATTTATC -> AAAATTTATCT
ACTAGGTTGTA -> CTAGGTTGTAT
TCGAGAGCGTA -> CGAGAGCGTAA
GCTAGATATCG -> CTAGATATCGG
CAAAAGTATGT -> AAAAGTATGTG
ACTACGATATT -> CTACGATATTT
CTAAATCTTGA -> TAAATCTTGAC
TCTGTACGCCG -> CTGTACGCCGG
TTATACTTATC -> TATACTTATCT
TATTATCAACT -> ATTATCAACTC
ATCACCAGATC -> TCACCAGATCA
CGAACCGCGGA -> GAACCGCGGAG
TGATAACACAT -> GATAACACATG
CCGCTAGTCTG -> CGCTAGTCTGA
CCGCTAAGAGA -> CGCTAAGAGAT
GCCGACCACAA -> CCGACCACAAT
TGTTAATGGCC -> GTTAATGGCCC
GGTCTTTTGAC -> GTCTTTTGACC
TCGTTGGGAGC -> CGTTGGGAGCA
GTCACTGTGAG -> TCACTGTGAGC
CTCGTGTAGTG -> TCGTGTAGTGC
GCCACACCAGT -> CCACACCAGTC
AGCCTCGCTTC -> GCCTCGCTTCA
TTAAGGACGAG -> TAAGGACGAGG
TCAATGACAGC -> CAATGACAGCG
GGTCTTGATTG -> GTCTTGATTGT
CCCCGCTTACA -> CCCGCTTACAG
CGCGCCGTAGG -> GCGCCGTAGGT
ACCACACTATC -> CCACACTATCA
TGTCCTCCTAA -> GTCCTCCTAAA
GCCTCACTAGG -> CCTCACTAGGT
TTCTGTCTTGT -> TCTGTCTTGTC
GTCTCTGAAAA -> TCTCTGAAAAC
TCTATTCAAAG -> CTATTCAAAGA
CCAAGTGTGTA -> CAAGTGTGTAG
GCGGTTGACTG -> CGGTTGACTGC
ATTTGCCTAAG -> TTTGCCTAAGC
TCTCATAATTT -> CTCATAATTTG
TCCCAGCATAG -> CCCAGCATAGA
TGCGCAAGCAA -> GCGCAAGCAAT
AAATATGACCT -> AATATGACCTC
TTTAGGCTACG -> TTAGGCTACGC
TAGGTTGTATC -> AGGTTGTATCC
GGCATGAGTGT -> GCATGAGTGTC
GTTGCTGCAGG -> TTGCTGCAGGA
GCGGGGCGTTC -> CGGGGCGTTCG
ACAGTATAGCG -> CAGTATAGCGG
GGAACGTGAGT -> GAACGTGAGTT
GATGAAAATTC -> ATGAAAATTCG
CCGGAACGTGA -> CGGAACGTGAG
CCCCGCAACGT -> CCCGCAACGTC
CGACCCTGACA -> GACCCTGACAG
CACTGTGAGCA -> ACTGTGAGCAT
GCCGTAGGTCT -> CCGTAGGTCTG
GTAACCGCTAA -> TAACCGCTAAG
GCCACGTAGGC -> CCACGTAGGCC
TGACCTCGGAA -> GACCTCGGAAG
CGTAGGCCACA -> GTAGGCCACAC
TGCCATATTAT -> GCCATATTATC
ATTTTAACCCT -> TTTTAACCCTT
TGTCTGTACGC -> GTCTGTACGCC
TAGGTCTGTGA -> AGGTCTGTGAA
GGATGTCCAGG -> GATGTCCAGGA
GCAGCCCACCG -> CAGCCCACCGC
GTGCGGTGAGC -> TGCGGTGAGCA
TCTAACGTTCC -> CTAACGTTCCC
AGCAATTAAGC -> GCAATTAAGCA
CAGTATAGCGG -> AGTATAGCGGT
GGTACCACGTG -> GTACCACGTGC
ACTTGAGTTTC -> CTTGAGTTTCT
CGGTCTCGGAG -> GGTCTCGGAGT
GGGACATGGTA -> GGACATGGTAC
CGATATTTTAA -> GATATTTTAAC
TGGTCTCCTGA -> GGTCTCCTGAG
CCTTCGGCGTT -> CTTCGGCGTTT
CACCTAAAAGA -> ACCTAAAAGAT
AACAATTTTCA -> ACAATTTTCAA
GTGAATCCTGG -> TGAATCCTGGT
ATGAACCACAA -> TGAACCACAAG
AATGCCACGTA -> ATGCCACGTAG
GGGCCGCGCAC -> GGCCGCGCACT
ACGCCGTACAG -> CGCCGTACAGA
AGAAGTCAGTT -> GAAGTCAGTTC
TTATCTGTGAA -> TATCTGTGAAC
TTTAAAGCTGA -> TTAAAGCTGAA
AATTCGCGATG -> ATTCGCGATGA
ATCTTGACTCT -> TCTTGACTCTC
AGGCTTTCTCG -> GGCTTTCTCGA
AAGTGATGCGG -> AGTGATGCGGC
GTAATACTCAG -> TAATACTCAGA
GAACTCTATAA -> AACTCTATAAA
CGCAGGGTTAC -> GCAGGGTTACT
ATGATTACAGC -> TGATTACAGCC
ACGTCTCTCGC -> CGTCTCTCGCC
CAAGTGATGCG -> AAGTGATGCGG
TTTTGTACACG -> TTTGTACACGA
TTATCACGTAG -> TATCACGTAGT
GCTGTTTTCAA -> CTGTTTTCAAG
ATCTTAAGGAC -> TCTTAAGGACG
GGCCGACTTGA -> GCCGACTTGAG
GGAAGGCTAAG -> GAAGGCTAAGC
GGGCCGACTCA -> GGCCGACTCAA
AGGCTAAGCCC -> GGCTAAGCCCC
CTACCTCGAAC -> TACCTCGAACG
CTCGGAGTGGT -> TCGGAGTGGTA
AAGGTCGCGCG -> AGGTCGCGCGG
GAACCACAAGT -> AACCACAAGTG
GATTGCGAAGG -> ATTGCGAAGGA
TCTCGGCGATT -> CTCGGCGATTT
GATACTATAAT -> ATACTATAATG
AAGATGAAAAT -> AGATGAAAATT
CGACGTCCGGC -> GACGTCCGGCA
GAGGGCCGGCA -> AGGGCCGGCAT
ACAGTGTTGTG -> CAGTGTTGTGT
AAAGACGATCT -> AAGACGATCTT
CGCGCGGCTTA -> GCGCGGCTTAT
TTGTTAACAAT -> TGTTAACAATC
ACCGCGGAGGC -> CCGCGGAGGCC
GGAGGCCGACT -> GAGGCCGACTT
ATGGATAAGGG -> TGGATAAGGGG
GCTTCGCCGGT -> CTTCGCCGGTG
TGTGCTCAAGG -> GTGCTCAAGGT
GATCCGTGTCT -> ATCCGTGTCTC
CTTCTCTAAAG -> TTCTCTAAAGG
CACTTCGACAG -> ACTTCGACAGT
AGTGGTACACG -> GTGGTACACGC
CGCGGCTTATA -> GCGGCTTATAC
GTGGATGATTA -> TGGATGATTAC
TCTTAAGGACG -> CTTAAGGACGA
ACTCATAAGCG -> CTCATAAGCGA
CAAGTACGAGG -> AAGTACGAGGG
GCGATGATAAC -> CGATGATAACG
AGAAACAGTGT -> GAAACAGTGTT
AGGACAGTCTG -> GGACAGTCTGG
CGACAGTTATC -> GACAGTTATCA
AATATGAAAGA -> ATATGAAAGAC
AGGCGGGGCGT -> GGCGGGGCGTT
CTCTAAAGTCG -> TCTAAAGTCGT
TACGATGACGC -> ACGATGACGCC
ACGATACCAGA -> CGATACCAGAC
GCACCTAAAAG -> CACCTAAAAGA
GTTTGGGTTTG -> TTTGGGTTTGC
TTCGTTAACAC -> TCGTTAACACA
AGGACCACAAG -> GGACCACAAGG
TCAACTCTATT -> CAACTCTATTC
TTGGGAGCAAG -> TGGGAGCAAGA
CTCCTGAGGTC -> TCCTGAGGTCA
GCGACGTCCGG -> CGACGTCCGGC
CCACACTATCA -> CACACTATCAC
CCGCTAGATAT -> CGCTAGATATC
TGGTCTGCAGC -> GGTCTGCAGCT
TGTCCCAGCAT -> GTCCCAGCATA
GAAAACTCGCG -> AAAACTCGCGT
CTCCGGCTCGT -> TCCGGCTCGTG
GCTAAGAGATC -> CTAAGAGATCT
ATTCGGTCTTT -> TTCGGTCTTTT
CCGGCATTTAG -> CGGCATTTAGA
AGGACCCGGGG -> GGACCCGGGGC
TCTATGCGCGC -> CTATGCGCGCA
TTGTATTAGTG -> TGTATTAGTGG
TACTAACAAAG -> ACTAACAAAGC
GCCGGCATTTA -> CCGGCATTTAG
CACCATCTAAC -> ACCATCTAACG
GCCTAGATACT -> CCTAGATACTA
GTGAGTGCTCA -> TGAGTGCTCAG
AGGCCACACCA -> GGCCACACCAG
CTTTGTAACCG -> TTTGTAACCGC
AACGGGGACAT -> ACGGGGACATG
CCATATAGACC -> CATATAGACCA
CGCGATGATAA -> GCGATGATAAC
CGGGGACATGG -> GGGGACATGGT
GGGAGCAAGAG -> GGAGCAAGAGG
ACCGCGCGTGC -> CCGCGCGTGCC
ATCAACTCTAT -> TCAACTCTATT
CGACAGGCCAC -> GACAGGCCACT
CGATCTTAAGG -> GATCTTAAGGA
TGTATCTCATA -> GTATCTCATAA
TGTAGTGCCAG -> GTAGTGCCAGA
GTGTAGTGCCA -> TGTAGTGCCAG
GCGCAAGCAAT -> CGCAAGCAATT
CGCTTACAGGC -> GCTTACAGGCG
AAGGGGTTTGG -> AGGGGTTTGGG
CACGACTGTCG -> ACGACTGTCGA
AGTATGTAGGT -> GTATGTAGGTC
GTATGTGCAAG -> TATGTGCAAGG
ACTCACTCATA -> CTCACTCATAA
TGCTCCGGCTC -> GCTCCGGCTCG
TAGACTTGTCT -> AGACTTGTCTA
AAGCTGAATTA -> AGCTGAATTAC
CTATGCCTTGA -> TATGCCTTGAG
AAAGATTGGAC -> AAGATTGGACT
CGATACCAGAC -> GATACCAGACA
TGCCTAAGCCT -> GCCTAAGCCTC
GGAGCAAGAGG -> GAGCAAGAGGG
ACTATCACGGG -> CTATCACGGGT
CGTACGCGCTG -> GTACGCGCTGT
GAAGTCGCCAC -> AAGTCGCCACA
TTATCTATGCC -> TATCTATGCCT
ATGGTACCACG -> TGGTACCACGT
CCACCGCGCGT -> CACCGCGCGTG
CGACTTGAGTT -> GACTTGAGTTT
CAGGATCCTTA -> AGGATCCTTAT
TATAACGCCTC -> ATAACGCCTCA
TAAAGTCGTTG -> AAAGTCGTTGG
CCTGAGGTCAC -> CTGAGGTCACT
TGGTACACGCT -> GGTACACGCTT
CGCCGTACAGA -> GCCGTACAGAA
CAAGTGTGTAG -> AAGTGTGTAGG
ATGACGCCGTA -> TGACGCCGTAC
CCCAGCATAGA -> CCAGCATAGAG
GTTCCCGAGTA -> TTCCCGAGTAA
TCACCCGCCCC -> CACCCGCCCCG
ACTTATCTGTG -> CTTATCTGTGA
AGGCCACTGGA -> GGCCACTGGAA
AAGTGAAGAGT -> AGTGAAGAGTT
ATCAACAGCCT -> TCAACAGCCTT
TCTCTCGCCCC -> CTCTCGCCCCG
ACTATAGGGAA -> CTATAGGGAAT
CCCCGGACACT -> CCCGGACACTA
CCCACTCACTC -> CCACTCACTCA
CGCAAAGATTG -> GCAAAGATTGC
CAATATGAAAG -> AATATGAAAGA
TGCCACGTAGG -> GCCACGTAGGC
ACGGATAATGC -> CGGATAATGCG
AGTTGCTGCAG -> GTTGCTGCAGG
AACATTGTTAA -> ACATTGTTAAC
TACACCATCTA -> ACACCATCTAA
ATTATCAACTC -> TTATCAACTCT
CATATAGACCA -> ATATAGACCAC
ACATTGTTAAC -> CATTGTTAACA
GGAGCGGAAAG -> GAGCGGAAAGC
CTCTATTACGA -> TCTATTACGAT
GACAGTTATCA -> ACAGTTATCAC
ACCCTGACAGG -> CCCTGACAGGA
GAACGATAGCT -> AACGATAGCTT
GGGGACATGGT -> GGGACATGGTA
ACTTTCTACTA -> CTTTCTACTAC
CACAGGCCCTT -> ACAGGCCCTTT
GAAAGTTCCAG -> AAAGTTCCAGA
GCGAGTTGTCT -> CGAGTTGTCTC
GTACAATCATA -> TACAATCATAC
CCACAATATGA -> CACAATATGAA
CCGCGCGTGCC -> CGCGCGTGCCC
GCTCGTGTAGT -> CTCGTGTAGTG
TTCAAGAGGGT -> TCAAGAGGGTT
AGTATAGCGGT -> GTATAGCGGTT
GGTCTGCAGCT -> GTCTGCAGCTT
TAGGTTTGCTA -> AGGTTTGCTAT
ATTAAGCACTA -> TTAAGCACTAC
CGCGGAGGCCG -> GCGGAGGCCGA
GTGCGCAAGCA -> TGCGCAAGCAA
AATGTGGACCC -> ATGTGGACCCA
CTAACCATATA -> TAACCATATAG
TGTCGAGAGCG -> GTCGAGAGCGT
TGGACTTTCTA -> GGACTTTCTAC
GCGTTTTTAGG -> CGTTTTTAGGC
TGGATGATTAC -> GGATGATTACA
AACGATAGCTT -> ACGATAGCTTC
GTGAGCATTCA -> TGAGCATTCAA
TGTTGTGTCCT -> GTTGTGTCCTC
CACTCATAGTA -> ACTCATAGTAA
ACTCTAAAGTC -> CTCTAAAGTCG
ATTACGATGAC -> TTACGATGACG
TCCTGGTCTCC -> CCTGGTCTCCT
TTCAGGAGCGG -> TCAGGAGCGGA
TCACTAGGTTG -> CACTAGGTTGT
AGGCTACGCGC -> GGCTACGCGCA
CTATTACGATG -> TATTACGATGA
GCCCAACGATC -> CCCAACGATCC
CAAAGCCGACC -> AAAGCCGACCA
GTGAAGAGTTG -> TGAAGAGTTGC
CAAGAGGGTTA -> AAGAGGGTTAT
GTGTTAATGGC -> TGTTAATGGCC
TATCACGGGTA -> ATCACGGGTAG
AAGCTGCGGAA -> AGCTGCGGAAC
CGGTCTTTTGA -> GGTCTTTTGAC
TTCGTTGCTTT -> TCGTTGCTTTG
GTACGAGGGTT -> TACGAGGGTTA
GAAAGACGATC -> AAAGACGATCT
GTTATGATTGA -> TTATGATTGAT
CACGATACCAG -> ACGATACCAGA
CTTATACTTAT -> TTATACTTATC
GCGAAAGTTCC -> CGAAAGTTCCA
CGCTGTTTTCA -> GCTGTTTTCAA
GTTGTATTAGT -> TTGTATTAGTG
ACTCGCGTCTT -> CTCGCGTCTTC
TAATACTCAGA -> AATACTCAGAG
CACGTAGGCCA -> ACGTAGGCCAC
ATATTTTAACC -> TATTTTAACCC
CGCGCTGTTTT -> GCGCTGTTTTC
TCAAAGTGGTC -> CAAAGTGGTCT
TGTATTAGTGG -> GTATTAGTGGA
TTCAATGACAG -> TCAATGACAGC
ACCAATTTGTC -> CCAATTTGTCG
AAATCTTGACT -> AATCTTGACTC
TAACACAAAAG -> AACACAAAAGT
TCAGAGCTCTA -> CAGAGCTCTAT
CGGAGGCCGAC -> GGAGGCCGACT
GAGAGCGTAAG -> AGAGCGTAAGA
ACTAACAAAGC -> CTAACAAAGCC
AAATTTATCTA -> AATTTATCTAT
ATTCAAAGATT -> TTCAAAGATTG
AGGGTTACTAA -> GGGTTACTAAC
GCTTCTACCAC -> CTTCTACCACA
TCTGAAAACTC -> CTGAAAACTCG
CTCGCCCCGCT -> TCGCCCCGCTT
ATAACGGGGAC -> TAACGGGGACA
ACGCGCACCAA -> CGCGCACCAAT
TCGTACGCGCT -> CGTACGCGCTG
CTAGGGCTTAA -> TAGGGCTTAAA
CTACCACACCC -> TACCACACCCG
AAAGTTCCAGA -> AAGTTCCAGAT
TGACTGCCTAG -> GACTGCCTAGA
AGTAAGCCATA -> GTAAGCCATAG
GTTACGACAAG -> TTACGACAAGA
ACAGCCTTCCC -> CAGCCTTCCCC
ACAGGCCACTG -> CAGGCCACTGG
GTGAGTTGTAT -> TGAGTTGTATT
AAGGATGGCAT -> AGGATGGCATT
TGAATCCTGGT -> GAATCCTGGTC
CACCAATGCCA -> ACCAATGCCAC
ATGATAACGGG -> TGATAACGGGG
CTCAAGGTCGC -> TCAAGGTCGCG
TGCGCGAAAGT -> GCGCGAAAGTT
TAGAAACAGTG -> AGAAACAGTGT
CCTAGATACTA -> CTAGATACTAT
TGCGGAACAAT -> GCGGAACAATT
TCGGAGTGGTA -> CGGAGTGGTAC
TGAGGTCACTG -> GAGGTCACTGT
CCAGGACCCGG -> CAGGACCCGGG
ATGCGGCACGA -> TGCGGCACGAA
CCGACCACAAT -> CGACCACAATA
GAGCGGAAAGC -> AGCGGAAAGCA
ACTGTGAGCAT -> CTGTGAGCATT
GCCCCGCAACG -> CCCCGCAACGT
CTGTGAACGGT -> TGTGAACGGTC
TGTCTTGTCCC -> GTCTTGTCCCA
GCCCACCGCGC -> CCCACCGCGCG
AATTGGTCTCA -> ATTGGTCTCAG
CCCACTTGTAA -> CCACTTGTAAG
AGATTGGACTT -> GATTGGACTTT
AGATATCGGTG -> GATATCGGTGA
AGCATTACTAA -> GCATTACTAAC
AAGGCTAAGCC -> AGGCTAAGCCC
AGCTTCTACCA -> GCTTCTACCAC
TATGCGCGCAG -> ATGCGCGCAGG
CAGTCTGGTAG -> AGTCTGGTAGT
ACTAAAGACCT -> CTAAAGACCTA
GTACCACGTGC -> TACCACGTGCG
ATCACGTAGTA -> TCACGTAGTAC
CTACACCATCT -> TACACCATCTA
ATTGAAGAGGG -> TTGAAGAGGGC
CAGTTCACTTC -> AGTTCACTTCG
CATATTATCAA -> ATATTATCAAC
TGAGTGCTCAG -> GAGTGCTCAGG
GCAATTAAGCA -> CAATTAAGCAC
CTATAATGTGG -> TATAATGTGGA
GGCAGCCCACC -> GCAGCCCACCG
TCACCAATGCC -> CACCAATGCCA
ACCGCTAAGAG -> CCGCTAAGAGA
AACCATATAGA -> ACCATATAGAC
GCTTTCTCGAA -> CTTTCTCGAAG
ACTTCGACAGT -> CTTCGACAGTT
ACCACAATATG -> CCACAATATGA
GGACATGGTAC -> GACATGGTACC
GAGAAAAGGTG -> AGAAAAGGTGA
ATTAGTGGATG -> TTAGTGGATGA
GTTTTTAGGCT -> TTTTTAGGCTA
CTAAGAGATCT -> TAAGAGATCTT
ACCAGATCAAT -> CCAGATCAATG
TCATAATTTGC -> CATAATTTGCC
CGACGGTTTGC -> GACGGTTTGCT
TTTATCTATGC -> TTATCTATGCC
CTTATAACGCC -> TTATAACGCCT
GTTGGGAGCAA -> TTGGGAGCAAG
GTGATGCGGCA -> TGATGCGGCAC
CCGGTGGCATG -> CGGTGGCATGA
GTTAACAATCA -> TTAACAATCAT
CGGAAAGCCGA -> GGAAAGCCGAC
TACACGCTTCT -> ACACGCTTCTC
GCGCCGTAGGT -> CGCCGTAGGTC
GCCACTGGAAG -> CCACTGGAAGG
CGCTAAGAGAT -> GCTAAGAGATC
GGGTTAGGATG -> GGTTAGGATGT
TATTCAAAGAT -> ATTCAAAGATT
GTCACGATACC -> TCACGATACCA
TTGAGTTTCTG -> TGAGTTTCTGT
ATACCAGACAA -> TACCAGACAAG
TTGTATCCGAC -> TGTATCCGACA
ATCATCCAAGT -> TCATCCAAGTG
CGAGGGTTACG -> GAGGGTTACGA
ACCATCTAACG -> CCATCTAACGT
AACTCGCGTCT -> ACTCGCGTCTT
TAACCGCTAAG -> AACCGCTAAGA
TTAAAGCTGAA -> TAAAGCTGAAT
CTCGAACGATA -> TCGAACGATAG
AAGCACCTAAA -> AGCACCTAAAA
TAAGGACGAGG -> AAGGACGAGGT
ATGAACTCTAC -> TGAACTCTACA
ATTTAAAGCTG -> TTTAAAGCTGA
CCCGCTAGATA -> CCGCTAGATAT
CGAAGCTGCGG -> GAAGCTGCGGA
ATTGGACTTTC -> TTGGACTTTCT
TGCCCAACGAT -> GCCCAACGATC
CGAGTAAGCCA -> GAGTAAGCCAT
GGACTTTCTAC -> GACTTTCTACT
CGAAGCTATGA -> GAAGCTATGAA
AGGCCGACTTG -> GGCCGACTTGA
AAGGAAATATG -> AGGAAATATGA
TAGGACCACAA -> AGGACCACAAG
GGAAATATGAC -> GAAATATGACC
CCTCGAACGAT -> CTCGAACGATA
TTGTCTAGGAC -> TGTCTAGGACA
ATAGCGGTTGA -> TAGCGGTTGAC
GCTGCAGGAAC -> CTGCAGGAACA
TTGCTATTCGG -> TGCTATTCGGT
AGGTTGTATCC -> GGTTGTATCCG
GCAGGGTTACT -> CAGGGTTACTA
GTATGTAGGTC -> TATGTAGGTCA
GTTTCAGGAGC -> TTTCAGGAGCG
AACAATCATCC -> ACAATCATCCA
CTAAAGTCGTT -> TAAAGTCGTTG
AGAGGCGCCAC -> GAGGCGCCACT
GAAAGCCGACC -> AAAGCCGACCC
TCCCTGAAGTG -> CCCTGAAGTGA
ATAAGCGACGT -> TAAGCGACGTC
ATTGTTAACAA -> TTGTTAACAAT
CTCTCGGCGAT -> TCTCGGCGATT
GACTTGAGTTT -> ACTTGAGTTTC
TCAATGTGTTA -> CAATGTGTTAA
AGTGAAGAGTT -> GTGAAGAGTTG
AAGCACTACGG -> AGCACTACGGG
CGGCGATTTGG -> GGCGATTTGGT
AGTGCTCAGGG -> GTGCTCAGGGT
CATGACTCACC -> ATGACTCACCA
TCTACACCATC -> CTACACCATCT
CCATATTATCA -> CATATTATCAA
TCGAAGCTGCG -> CGAAGCTGCGG
TCACTCTAAAG -> CACTCTAAAGT
GATAATGCGCG -> ATAATGCGCGC
TGGCATGAGTG -> GGCATGAGTGT
TTGCGCGAAAG -> TGCGCGAAAGT
ATACTTATCTG -> TACTTATCTGT
GAATTACAACT -> AATTACAACTT
