AAAGGATTGTATTCTGGGA -> AAGGATTGTATTCTGGGAA
ATAGTCCCTGTAGTTGGTT -> TAGTCCCTGTAGTTGGTTT
GAACCTCTTTAGACCCGTT -> AACCTCTTTAGACCCGTTT
TGCATACACAGCGTGCCAA -> GCATACACAGCGTGCCAAC
CACTCACATTGTGGCAACT -> ACTCACATTGTGGCAACTG
CCCACTACTTTACACCTTT -> CCACTACTTTACACCTTTA
AGGATATTTTACGATCAAG -> GGATATTTTACGATCAAGG
AGGAACCCGGGACACTCAC -> GGAACCCGGGACACTCACA
CGTAAAATGGGCGAATGAC -> GTAAAATGGGCGAATGACA
GATTAGACATGATCTTCAA -> ATTAGACATGATCTTCAAC
GACCCCGTGTGGATTAGAC -> ACCCCGTGTGGATTAGACA
TTACCTTATCATTACTCCT -> TACCTTATCATTACTCCTG
GTAGCCATCACTATGACGT -> TAGCCATCACTATGACGTT
CAGATACGCCACCCACAGC -> AGATACGCCACCCACAGCC
TGTCTTGCCTACCTTGTTT -> GTCTTGCCTACCTTGTTTC
TCTGCTGCTTTTATCCCCA -> CTGCTGCTTTTATCCCCAC
TGACCGTTACTTGAGTGTG -> GACCGTTACTTGAGTGTGA
TGAATAGATTAAATCCTCG -> GAATAGATTAAATCCTCGG
TGATTGGGAGCAAGTATAA -> GATTGGGAGCAAGTATAAA
AGTATCCGTTTGGTATGGC -> GTATCCGTTTGGTATGGCT
TTCGACGCTCCGGCTGTGG -> TCGACGCTCCGGCTGTGGA
CACAGCAGTGGGACCGAGC -> ACAGCAGTGGGACCGAGCC
TTCGCGCAGACATACGCAG -> TCGCGCAGACATACGCAGG
AAATCTTGAGAACACTCCC -> AATCTTGAGAACACTCCCT
TGTAGCCATCACTATGACG -> GTAGCCATCACTATGACGT
TGCGGTCTGCATACACAGC -> GCGGTCTGCATACACAGCG
ATAAAGTCTGGAGCTAGGC -> TAAAGTCTGGAGCTAGGCT
CGCTGTGTGGATAAGCCGG -> GCTGTGTGGATAAGCCGGA
CCATTCTGGTGATAGTCCC -> CATTCTGGTGATAGTCCCT
ACATACGCAGGAACCCGGG -> CATACGCAGGAACCCGGGA
GGACCGAGCCCCATGAGGA -> GACCGAGCCCCATGAGGAA
GACATAACTAGACCCAGAC -> ACATAACTAGACCCAGACA
AGCTTGTAGTGCGCTAGCA -> GCTTGTAGTGCGCTAGCAA
GTCCCGGTAGCTCTCCGCC -> TCCCGGTAGCTCTCCGCCT
TACTGCCGCCTCCATGGCT -> ACTGCCGCCTCCATGGCTT
CGGTGAGATACGCCACCCA -> GGTGAGATACGCCACCCAC
GCCCCATGAGGAATAGACC -> CCCCATGAGGAATAGACCA
ACAGTTCTACTGCCCGAGA -> CAGTTCTACTGCCCGAGAG
CTTGCCTTCATCGGCAGTG -> TTGCCTTCATCGGCAGTGA
CGGGCCGGTACATTTTATG -> GGGCCGGTACATTTTATGA
ACTACCTCGCTTTAGTCTC -> CTACCTCGCTTTAGTCTCG
GTGACTCCCGTTATAACGT -> TGACTCCCGTTATAACGTC
CCTCGCTTTAGTCTCGACG -> CTCGCTTTAGTCTCGACGT
CCCAAAATTAAAAGCCCCG -> CCAAAATTAAAAGCCCCGC
TAAGATCACGACTTTTTGA -> AAGATCACGACTTTTTGAG
TAAAAAAGCTTGTAGTGCG -> AAAAAAGCTTGTAGTGCGC
GCCGACATTGAACTGAGAC -> CCGACATTGAACTGAGACG
ACACCTGCGTTGTAAGGCT -> CACCTGCGTTGTAAGGCTA
CTCCCGTTATAACGTCCAT -> TCCCGTTATAACGTCCATC
CTGTGTGGATAAGCCGGAT -> TGTGTGGATAAGCCGGATC
CACAGCGTGCCAACCCAGT -> ACAGCGTGCCAACCCAGTG
TTATGACTTGTTCCCGTCT -> TATGACTTGTTCCCGTCTA
CAAGATACGCCACCCACAG -> AAGATACGCCACCCACAGC
CCAGGACCTCAGGGGTCGA -> CAGGACCTCAGGGGTCGAC
CGATTGTTAACGTAAAATG -> GATTGTTAACGTAAAATGG
TTCCCCAGGACCTCAGGGG -> TCCCCAGGACCTCAGGGGT
CTCTCATCCTGACCCCTGT -> TCTCATCCTGACCCCTGTA
TCAATTCAGCTTAGATAGG -> CAATTCAGCTTAGATAGGC
GACTCCCGTTTGAACCCGT -> ACTCCCGTTTGAACCCGTG
ACGATAGGTAGACGAGGAA -> CGATAGGTAGACGAGGAAG
AGCGAAGGATGTCGTACAC -> GCGAAGGATGTCGTACACA
TTGGCATGTGATATGTACG -> TGGCATGTGATATGTACGG
ACAGCTTTTAGGTAGTGGT -> CAGCTTTTAGGTAGTGGTC
AAATATGAGGCCCGCGAGT -> AATATGAGGCCCGCGAGTG
TGCGGTCGTGATTTCCCCA -> GCGGTCGTGATTTCCCCAT
AGTTTAGTACTAGCCCTCC -> GTTTAGTACTAGCCCTCCC
TGCCTTCGAGGGTGTCCGT -> GCCTTCGAGGGTGTCCGTG
CATGGCTTCGAACAGGACA -> ATGGCTTCGAACAGGACAT
GAATAGATACGCCACCCAC -> AATAGATACGCCACCCACA
TACACATGATTTCGCGCAG -> ACACATGATTTCGCGCAGA
CCGACGCAAATATGAGGCC -> CGACGCAAATATGAGGCCC
CCGCGTGTCGTGTGACCGT -> CGCGTGTCGTGTGACCGTT
CATCGGTACCCCCATGGTC -> ATCGGTACCCCCATGGTCG
CGTCGAACACCAAGAGTAC -> GTCGAACACCAAGAGTACA
AGCATATCATCGGTACCCC -> GCATATCATCGGTACCCCC
TGCTTTACCTTATCATTAC -> GCTTTACCTTATCATTACT
GGGTTATGACTTGTTCCCG -> GGTTATGACTTGTTCCCGT
GATAGGCCGACATTGAACT -> ATAGGCCGACATTGAACTG
ATTAGACATGATCTTCAAC -> TTAGACATGATCTTCAACT
GAGGAAGCATATCATCGGT -> AGGAAGCATATCATCGGTA
CCATCGTGCTGATGTTGAT -> CATCGTGCTGATGTTGATG
TCGGTGCCCAATCCCAATC -> CGGTGCCCAATCCCAATCG
CTTAGATAGGCCGACATTG -> TTAGATAGGCCGACATTGA
TGTGGATTAGACATGATCT -> GTGGATTAGACATGATCTT
GTCATACTCTAGAGAAGCG -> TCATACTCTAGAGAAGCGC
CAAGGGCCGGGATTAGACC -> AAGGGCCGGGATTAGACCG
GCAAGAGGACAGCGGTCTG -> CAAGAGGACAGCGGTCTGC
GACTTTTTGAGGTACTACC -> ACTTTTTGAGGTACTACCT
AGCGTGCCAACCCAGTGAC -> GCGTGCCAACCCAGTGACC
CTTTTTGAGGTACTACCTC -> TTTTTGAGGTACTACCTCG
TCGTGCTGATGTTGATGCA -> CGTGCTGATGTTGATGCAG
TGCCCAAATTAATCCGCGT -> GCCCAAATTAATCCGCGTG
ATGTACGGAGGTCGGTAAA -> TGTACGGAGGTCGGTAAAA
GTACCCCCATGGTCGCGTG -> TACCCCCATGGTCGCGTGT
CGGGACACTCACATTGTGG -> GGGACACTCACATTGTGGC
TCATCGGCAGTGATGATTT -> CATCGGCAGTGATGATTTC
GCGTGGCCTGTATACGATC -> CGTGGCCTGTATACGATCT
ACACCCACTTGTTACCAGT -> CACCCACTTGTTACCAGTA
TCACATTGTGGCAACTGGC -> CACATTGTGGCAACTGGCA
ACCAACACACTGGTGTTCA -> CCAACACACTGGTGTTCAC
ATATAGTAGGACAGTCCCA -> TATAGTAGGACAGTCCCAA
GTATCCGTTTGGTATGGCT -> TATCCGTTTGGTATGGCTG
AATCCTCGGGCCGTCAATC -> ATCCTCGGGCCGTCAATCG
GCAATGCTGGGGTTGGCAT -> CAATGCTGGGGTTGGCATG
GACTCTTGCCTTCATCGGC -> ACTCTTGCCTTCATCGGCA
ATCCCAATCGAGTAAATAG -> TCCCAATCGAGTAAATAGT
TATCCGTTTGGTATGGCTG -> ATCCGTTTGGTATGGCTGG
CTGCATACACAGCGTGGCC -> TGCATACACAGCGTGGCCT
TGCAGGAACCGTCTAGACC -> GCAGGAACCGTCTAGACCC
ATTCGACGCTCCGGCTGTG -> TTCGACGCTCCGGCTGTGG
CTGATTAATGGTGAGGCAC -> TGATTAATGGTGAGGCACG
AACAGGTCTAGATTAAGGG -> ACAGGTCTAGATTAAGGGT
GCATGTGATATGTACGGAG -> CATGTGATATGTACGGAGG
TGATGTTGATGCAGGAACC -> GATGTTGATGCAGGAACCG
AAGCCCCGCTTTGATGTGG -> AGCCCCGCTTTGATGTGGC
ACACTCACATTGTGGCAAC -> CACTCACATTGTGGCAACT
CGCTGAACAGTCGGCTGGC -> GCTGAACAGTCGGCTGGCA
AAACAGGCGACCGTACGAT -> AACAGGCGACCGTACGATC
GTCAAATTTGCTCGTGAAC -> TCAAATTTGCTCGTGAACA
GCCACCCACAGCAAGAGGA -> CCACCCACAGCAAGAGGAC
GTAGTTGGTTTCCACGTAC -> TAGTTGGTTTCCACGTACT
TACTAGCCCTCCCCAGTCT -> ACTAGCCCTCCCCAGTCTT
TCTGCATACACAGCGTGGC -> CTGCATACACAGCGTGGCC
TTTTGAGGTACTACCTCGC -> TTTGAGGTACTACCTCGCT
AGTCCCAAAATTAAAAGCC -> GTCCCAAAATTAAAAGCCC
ACGGTGCAGGACACACCTG -> CGGTGCAGGACACACCTGC
AAAGCATGCGCTCTCGTAC -> AAGCATGCGCTCTCGTACC
CCAAAGCATGCGCTCTCGT -> CAAAGCATGCGCTCTCGTA
TTTACACCTTTAGCCAATA -> TTACACCTTTAGCCAATAT
CCTCGGGCCGGTACATTTT -> CTCGGGCCGGTACATTTTA
TCGGAAGGTCATACTCTAG -> CGGAAGGTCATACTCTAGA
CTGCAGAACACAGCAGTGG -> TGCAGAACACAGCAGTGGG
CTCGTGCGGGGTTATGACT -> TCGTGCGGGGTTATGACTT
TTAGTACTAGCCCTCCCCA -> TAGTACTAGCCCTCCCCAG
CTCGACGTCCCGGTAGCTC -> TCGACGTCCCGGTAGCTCT
GTTGGCCGATTCTGGCACC -> TTGGCCGATTCTGGCACCC
TGTGATATGTACGGAGGTC -> GTGATATGTACGGAGGTCG
ATGTACGATAGGTAGACGA -> TGTACGATAGGTAGACGAG
CTTTAGCCAATATGGCCGA -> TTTAGCCAATATGGCCGAT
ACGAGGAAGCATATCATCG -> CGAGGAAGCATATCATCGG
TGCGGGGTTATGACTTGTT -> GCGGGGTTATGACTTGTTC
CTAGACCCAGACAATGCTT -> TAGACCCAGACAATGCTTA
AGACCCCGTGTGGATTAGA -> GACCCCGTGTGGATTAGAC
ATTGAACTGAGACGCTGTG -> TTGAACTGAGACGCTGTGT
CATGAGGAATAGACCAAGA -> ATGAGGAATAGACCAAGAT
CTTACAACTTCATTGACAT -> TTACAACTTCATTGACATA
CAAAATTAAAAGCCCCGCT -> AAAATTAAAAGCCCCGCTT
TGAACAATGTAGGATATTT -> GAACAATGTAGGATATTTT
GGTTATGACTTGTTCCCGT -> GTTATGACTTGTTCCCGTC
GTGGCAACTGGCATACTGC -> TGGCAACTGGCATACTGCC
TGTCCGTGCGGTCGTGATT -> GTCCGTGCGGTCGTGATTT
CCTTCGAGGGTGTCCGTGC -> CTTCGAGGGTGTCCGTGCG
AGCCCTCCCCAGTCTTCAT -> GCCCTCCCCAGTCTTCATA
TAGTATCCGTTTGGTATGG -> AGTATCCGTTTGGTATGGC
AACTAGACCCAGACAATGC -> ACTAGACCCAGACAATGCT
CTCCGGCTGTGGACTCTCG -> TCCGGCTGTGGACTCTCGT
TAAAGTCTGGAGCTAGGCT -> AAAGTCTGGAGCTAGGCTT
GGCTTTGAGTATGAACCTC -> GCTTTGAGTATGAACCTCT
CGCCACCCACAGCTTTTAG -> GCCACCCACAGCTTTTAGG
CAAATTAATCCGCGTGTCG -> AAATTAATCCGCGTGTCGT
GTAGGACAGTCCCAAAATT -> TAGGACAGTCCCAAAATTA
CCGTGCGGGCTGACCCACT -> CGTGCGGGCTGACCCACTA
AAAATGGGCGAATGACACG -> AAATGGGCGAATGACACGC
GCACGTTACTCCTCGGGCC -> CACGTTACTCCTCGGGCCG
ATGGTTATCGTGCCTTCGA -> TGGTTATCGTGCCTTCGAG
CGGCTGGCAAGCCAGCTAA -> GGCTGGCAAGCCAGCTAAT
CCGGATCTATCAGTCTAAG -> CGGATCTATCAGTCTAAGA
TAGCCCTCCCCAGTCTTCA -> AGCCCTCCCCAGTCTTCAT
CTTATGCTTACAACTTCAT -> TTATGCTTACAACTTCATT
TGTCTGCTGCTTTTATCCC -> GTCTGCTGCTTTTATCCCC
GTTTGGGCAATGTCAAATT -> TTTGGGCAATGTCAAATTT
GAACACCAAGAGTACATGC -> AACACCAAGAGTACATGCG
TCACTATGACGTTGGCCGA -> CACTATGACGTTGGCCGAT
TGTAGGATATTTTACGATC -> GTAGGATATTTTACGATCA
CTTCGAGGGTGTCCGTGCG -> TTCGAGGGTGTCCGTGCGG
GTCTAAACAGGCGACCGTA -> TCTAAACAGGCGACCGTAC
AAATGGGCGAATGACACGC -> AATGGGCGAATGACACGCG
CTCACACCAACACACTGGT -> TCACACCAACACACTGGTG
TACACAGCGTGGCCTGTAT -> ACACAGCGTGGCCTGTATA
CTGGCAAGCCAGCTAATGA -> TGGCAAGCCAGCTAATGAC
CCCTAGCTAGCGCAAAAAA -> CCTAGCTAGCGCAAAAAAA
CAACTTCATTGACATAACT -> AACTTCATTGACATAACTA
GCATACACAGCGTGCCAAC -> CATACACAGCGTGCCAACC
TACACAGCGTGCCAACCCA -> ACACAGCGTGCCAACCCAG
ACAGCGGTCTGCATACACA -> CAGCGGTCTGCATACACAG
GCCGATTCTGGCACCCTTG -> CCGATTCTGGCACCCTTGA
ACATACTCTCATCCTGACC -> CATACTCTCATCCTGACCC
GTCAGGCTTTGAGTATGAA -> TCAGGCTTTGAGTATGAAC
ACGGAGGTCGGTAAAAATA -> CGGAGGTCGGTAAAAATAA
CTCTTGCCTTCATCGGCAG -> TCTTGCCTTCATCGGCAGT
TACACCTTTAGCCAATATG -> ACACCTTTAGCCAATATGG
GAACAGTCGGCTGGCAAGC -> AACAGTCGGCTGGCAAGCC
GGTCGACGGTGCAGGACAC -> GTCGACGGTGCAGGACACA
CGAAGGATGTCGTACACAT -> GAAGGATGTCGTACACATG
ACTCTCGTGCGGGGTTATG -> CTCTCGTGCGGGGTTATGA
CTGGTGTTCACTTTGAGTC -> TGGTGTTCACTTTGAGTCT
CTCATGGTTATCGTGCCTT -> TCATGGTTATCGTGCCTTC
AGAACTTATGCTTACAACT -> GAACTTATGCTTACAACTT
ATTAGGTGAATTGGAATAG -> TTAGGTGAATTGGAATAGA
GGAGGTCGGTAAAAATAAC -> GAGGTCGGTAAAAATAACT
TCCGAAGAACTTATGCTTA -> CCGAAGAACTTATGCTTAC
ATGGCTTCGAACAGGACAT -> TGGCTTCGAACAGGACATG
ACCCGGGACACTCACATTG -> CCCGGGACACTCACATTGT
AATAGACCAAGATACGCCA -> ATAGACCAAGATACGCCAC
GAGGGAAAGGATTGTATTC -> AGGGAAAGGATTGTATTCT
GATTGTTAACGTAAAATGG -> ATTGTTAACGTAAAATGGG
GACAATGCTTAGCGAAGGA -> ACAATGCTTAGCGAAGGAT
TGATATGTACGGAGGTCGG -> GATATGTACGGAGGTCGGT
CAGCGTTGAATTTGGGGTC -> AGCGTTGAATTTGGGGTCT
CGTCCATCGTGCTGATGTT -> GTCCATCGTGCTGATGTTG
CTTCATAAGTAAGCCACGA -> TTCATAAGTAAGCCACGAC
GTCTAGACCCCGTGTGGAT -> TCTAGACCCCGTGTGGATT
TCCCTGTAGTTGGTTTCCA -> CCCTGTAGTTGGTTTCCAC
GGACATGCCCAAATTAATC -> GACATGCCCAAATTAATCC
TTAGGTGAATTGGAATAGA -> TAGGTGAATTGGAATAGAT
CTCCATGGCTTCGAACAGG -> TCCATGGCTTCGAACAGGA
CAGGTACTGTAGTTATATG -> AGGTACTGTAGTTATATGC
CAGTGATGATTTCCGAAGA -> AGTGATGATTTCCGAAGAA
ATGATCTTCAACTCCCCAA -> TGATCTTCAACTCCCCAAA
GATTAAATCCTCGGGCCGT -> ATTAAATCCTCGGGCCGTC
CAGGCTTTGAGTATGAACC -> AGGCTTTGAGTATGAACCT
TGGTATGGCTGGTATCTTC -> GGTATGGCTGGTATCTTCA
ACCTGCGTTGTAAGGCTAT -> CCTGCGTTGTAAGGCTATC
ACATGCGAGTCGAACTGCA -> CATGCGAGTCGAACTGCAG
AGCAACACCCACTTGTTAC -> GCAACACCCACTTGTTACC
AATGCTGGGGTTGGCATGT -> ATGCTGGGGTTGGCATGTG
TGTGTGGATAAGCCGGATC -> GTGTGGATAAGCCGGATCT
CCACCCACAGCTTTTAGGT -> CACCCACAGCTTTTAGGTA
ATTTCCGAAGAACTTATGC -> TTTCCGAAGAACTTATGCT
TTTGAGTCTTAGTAAGGAA -> TTGAGTCTTAGTAAGGAAA
ATACACAGCGTGGCCTGTA -> TACACAGCGTGGCCTGTAT
CCAAAATTAAAAGCCCCGC -> CAAAATTAAAAGCCCCGCT
GAGCTAGGCTTAACTCACA -> AGCTAGGCTTAACTCACAC
TCAAGCGTCGAACACCAAG -> CAAGCGTCGAACACCAAGA
AATAGATTAAATCCTCGGG -> ATAGATTAAATCCTCGGGC
ATAACTATGTACGATAGGT -> TAACTATGTACGATAGGTA
CTACTAAAAAAGCTTGTAG -> TACTAAAAAAGCTTGTAGT
GCTTTGATGTGGCCAATCG -> CTTTGATGTGGCCAATCGG
AAAGCGTCTCATGGTTATC -> AAGCGTCTCATGGTTATCG
GGTACTACCTCGCTTTAGT -> GTACTACCTCGCTTTAGTC
CTCAGGGGTCGACGGTGCA -> TCAGGGGTCGACGGTGCAG
CAGACATACGCAGGAACCC -> AGACATACGCAGGAACCCG
ACCCTCTCGGATCTGTCTT -> CCCTCTCGGATCTGTCTTG
TCTGGCACCCTTGATATAG -> CTGGCACCCTTGATATAGT
TGAATTTGGGGTCTGCATA -> GAATTTGGGGTCTGCATAC
GTTGGCATGTGATATGTAC -> TTGGCATGTGATATGTACG
GGGAGCAAGTATAAAGCGT -> GGAGCAAGTATAAAGCGTC
CATAAGTAAGCCACGACTG -> ATAAGTAAGCCACGACTGA
TGGATAAGCCGGATCTATC -> GGATAAGCCGGATCTATCA
AGTGCGCTAGCAACACCCA -> GTGCGCTAGCAACACCCAC
CGGGGTTATGACTTGTTCC -> GGGGTTATGACTTGTTCCC
GATGCCGACGCAAATATGA -> ATGCCGACGCAAATATGAG
GAGATACGCCACCCACAGC -> AGATACGCCACCCACAGCG
TCTCCGCCTGCAGAATCTT -> CTCCGCCTGCAGAATCTTA
TTGTATTCTGGGAATTCGA -> TGTATTCTGGGAATTCGAC
TTGTTCCCGTCTAGATTTC -> TGTTCCCGTCTAGATTTCC
TCCCAATCGAGTAAATAGT -> CCCAATCGAGTAAATAGTA
ACCCCCATGGTCGCGTGTC -> CCCCCATGGTCGCGTGTCA
TTGGGCAATGTCAAATTTG -> TGGGCAATGTCAAATTTGC
TGGGCAATGTCAAATTTGC -> GGGCAATGTCAAATTTGCT
TCTATCAGTCTAAGATCAC -> CTATCAGTCTAAGATCACG
TCGCTTTAGTCTCGACGTC -> CGCTTTAGTCTCGACGTCC
GACGAGGAAGCATATCATC -> ACGAGGAAGCATATCATCG
CTAAACAGGCGACCGTACG -> TAAACAGGCGACCGTACGA
TATCATTACTCCTGATGCC -> ATCATTACTCCTGATGCCG
TTGCCTACCTTGTTTCGCC -> TGCCTACCTTGTTTCGCCT
CGAGCCCCATGAGGAATAG -> GAGCCCCATGAGGAATAGA
CTGTAGTTATATGCCCGTG -> TGTAGTTATATGCCCGTGC
GGTCATACTCTAGAGAAGC -> GTCATACTCTAGAGAAGCG
ATGACTTGTTCCCGTCTAG -> TGACTTGTTCCCGTCTAGA
CCATCCCCTAGCTAGCGCA -> CATCCCCTAGCTAGCGCAA
TCAAGGGCCGGGATTAGAC -> CAAGGGCCGGGATTAGACC
ATCCGTTTGGTATGGCTGG -> TCCGTTTGGTATGGCTGGT
TCATCCTGACCCCTGTACC -> CATCCTGACCCCTGTACCA
CTCAGCTGAGCAATGCTGG -> TCAGCTGAGCAATGCTGGG
GGTAAAAATAACTATGTAC -> GTAAAAATAACTATGTACG
CCAGCTAATGACCCTCTCG -> CAGCTAATGACCCTCTCGG
CCCGTTTGATCACCATCCC -> CCGTTTGATCACCATCCCC
TTATGATTGGGAGCAAGTA -> TATGATTGGGAGCAAGTAT
GAGAGAAAATCTTGAGAAC -> AGAGAAAATCTTGAGAACA
CCACCCACAGCCTGTTGCG -> CACCCACAGCCTGTTGCGG
TTCGCCTCAGCTGAGCAAT -> TCGCCTCAGCTGAGCAATG
TACCTTGTTTCGCCTCAGC -> ACCTTGTTTCGCCTCAGCT
AATCGAGTAAATAGTATCC -> ATCGAGTAAATAGTATCCG
GCCTGCAGAATCTTAATAG -> CCTGCAGAATCTTAATAGT
ACATGCCCAAATTAATCCG -> CATGCCCAAATTAATCCGC
CCCGAGAGAAAATCTTGAG -> CCGAGAGAAAATCTTGAGA
ACCCTTGATATAGTAGGAC -> CCCTTGATATAGTAGGACA
GTGGCCAATCGGTGCCCAA -> TGGCCAATCGGTGCCCAAT
TCAATCGATCCGGAGGGAA -> CAATCGATCCGGAGGGAAA
GACCCAGACAATGCTTAGC -> ACCCAGACAATGCTTAGCG
GTCTAGATTTCCCCAGGAC -> TCTAGATTTCCCCAGGACC
GTGCTGATGTTGATGCAGG -> TGCTGATGTTGATGCAGGA
ACTACTAAAAAAGCTTGTA -> CTACTAAAAAAGCTTGTAG
AACTATGTACGATAGGTAG -> ACTATGTACGATAGGTAGA
AAAAAGCTTGTAGTGCGCT -> AAAAGCTTGTAGTGCGCTA
AGAGGACAGCGGTCTGCAT -> GAGGACAGCGGTCTGCATA
ATGCGCTCTCGTACCAAGT -> TGCGCTCTCGTACCAAGTT
AGTATAAAGCGTCTCATGG -> GTATAAAGCGTCTCATGGT
TTCGAGGGTGTCCGTGCGG -> TCGAGGGTGTCCGTGCGGT
ATCACGACTTTTTGAGGTA -> TCACGACTTTTTGAGGTAC
ACCTTATCATTACTCCTGA -> CCTTATCATTACTCCTGAT
TGCCTACCTTGTTTCGCCT -> GCCTACCTTGTTTCGCCTC
TCCGCCTGCAGAATCTTAA -> CCGCCTGCAGAATCTTAAT
CGGGCTGACCCACTACTTT -> GGGCTGACCCACTACTTTA
ACGCTGTGTGGATAAGCCG -> CGCTGTGTGGATAAGCCGG
CACTATGACGTTGGCCGAT -> ACTATGACGTTGGCCGATT
AGTAATTAGGTGAATTGGA -> GTAATTAGGTGAATTGGAA
TTGAGTATGAACCTCTTTA -> TGAGTATGAACCTCTTTAG
CTCTCGTACCAAGTTTAGT -> TCTCGTACCAAGTTTAGTA
AGCTAATGACCCTCTCGGA -> GCTAATGACCCTCTCGGAT
ACGCCACCCACAGCAAGAG -> CGCCACCCACAGCAAGAGG
GGATGTCGTACACATGATT -> GATGTCGTACACATGATTT
GCTGAGCAATGCTGGGGTT -> CTGAGCAATGCTGGGGTTG
CAAGTTTAGTACTAGCCCT -> AAGTTTAGTACTAGCCCTC
TCATGGTTATCGTGCCTTC -> CATGGTTATCGTGCCTTCG
GATAAGCCGGATCTATCAG -> ATAAGCCGGATCTATCAGT
CGGTCGTGATTTCCCCATT -> GGTCGTGATTTCCCCATTC
GGTTGGCATGTGATATGTA -> GTTGGCATGTGATATGTAC
AACTGGCATACTGCCGCCT -> ACTGGCATACTGCCGCCTC
TACCTTATCATTACTCCTG -> ACCTTATCATTACTCCTGA
CCTGCAGAACACAGCAGTG -> CTGCAGAACACAGCAGTGG
GTGCCAACCCAGTGACCAT -> TGCCAACCCAGTGACCATC
ATACTCTAGAGAAGCGCTC -> TACTCTAGAGAAGCGCTCG
ACCCGTTTGATCACCATCC -> CCCGTTTGATCACCATCCC
GATAGTCCCTGTAGTTGGT -> ATAGTCCCTGTAGTTGGTT
TGTCGTACACATGATTTCG -> GTCGTACACATGATTTCGC
ACCGTCTAGACCCCGTGTG -> CCGTCTAGACCCCGTGTGG
TTTGGGGTCTGCATACACA -> TTGGGGTCTGCATACACAG
AACACACTGGTGTTCACTT -> ACACACTGGTGTTCACTTT
GAACAGGACATGCCCAAAT -> AACAGGACATGCCCAAATT
TGCATACACAGCGTGAGTC -> GCATACACAGCGTGAGTCA
TTGCCTTCATCGGCAGTGA -> TGCCTTCATCGGCAGTGAT
TCGTCGACTCTTGCCTTCA -> CGTCGACTCTTGCCTTCAT
AGGATGTCGTACACATGAT -> GGATGTCGTACACATGATT
CCGTCTAGACCCCGTGTGG -> CGTCTAGACCCCGTGTGGA
CTGCTGCTTTTATCCCCAC -> TGCTGCTTTTATCCCCACA
AGTACATGCGAGTCGAACT -> GTACATGCGAGTCGAACTG
AGAACACAGCAGTGGGACC -> GAACACAGCAGTGGGACCG
GTGTCGTGTGACCGTTACT -> TGTCGTGTGACCGTTACTT
CATTGTGGCAACTGGCATA -> ATTGTGGCAACTGGCATAC
GCTTGAATAGATTAAATCC -> CTTGAATAGATTAAATCCT
AGCTCTCCGCCTGCAGAAT -> GCTCTCCGCCTGCAGAATC
TGTCAAATTTGCTCGTGAA -> GTCAAATTTGCTCGTGAAC
AAAAGCTTGTAGTGCGCTA -> AAAGCTTGTAGTGCGCTAG
GCCTGTATACGATCTTTCA -> CCTGTATACGATCTTTCAT
CTATCATATCGTCTAAACA -> TATCATATCGTCTAAACAG
TACATACTCTCATCCTGAC -> ACATACTCTCATCCTGACC
CATGATCTTCAACTCCCCA -> ATGATCTTCAACTCCCCAA
ACTGCAGCCCCCGTTCGTC -> CTGCAGCCCCCGTTCGTCG
ATGATTGGGAGCAAGTATA -> TGATTGGGAGCAAGTATAA
TTGATGCAGGAACCGTCTA -> TGATGCAGGAACCGTCTAG
AGCTAGCGCAAAAAAATGC -> GCTAGCGCAAAAAAATGCT
GTCTGGAGCTAGGCTTAAC -> TCTGGAGCTAGGCTTAACT
CTAATGACCCTCTCGGATC -> TAATGACCCTCTCGGATCT
AAAAATAACTATGTACGAT -> AAAATAACTATGTACGATA
ACGCAAATATGAGGCCCGC -> CGCAAATATGAGGCCCGCG
TTGATCACCATCCCCTAGC -> TGATCACCATCCCCTAGCT
GGCTTAACTCACACCAACA -> GCTTAACTCACACCAACAC
GATCTTTCATTTCGTATGG -> ATCTTTCATTTCGTATGGC
TTCATTTCGTATGGCATTA -> TCATTTCGTATGGCATTAA
AGACCCAGACAATGCTTAG -> GACCCAGACAATGCTTAGC
CACGACTGATTAATGGTGA -> ACGACTGATTAATGGTGAG
TACTTGAGTGTGACTCCCG -> ACTTGAGTGTGACTCCCGT
GCCTGTTGCGGTGAGATAC -> CCTGTTGCGGTGAGATACG
CTCTCGGATCTGTCTTGCC -> TCTCGGATCTGTCTTGCCT
TCAGTCTAAGATCACGACT -> CAGTCTAAGATCACGACTT
TTATCCCCACACAGTTCTA -> TATCCCCACACAGTTCTAC
GCCACCCACAGCGTTGAAT -> CCACCCACAGCGTTGAATT
ACACACCTGCGTTGTAAGG -> CACACCTGCGTTGTAAGGC
GATACGCCACCCACAGCTT -> ATACGCCACCCACAGCTTT
CCGTTTGGTATGGCTGGTA -> CGTTTGGTATGGCTGGTAT
CCAGACAATGCTTAGCGAA -> CAGACAATGCTTAGCGAAG
GAGTCGAACTGCAGCCCCC -> AGTCGAACTGCAGCCCCCG
TAGGTAGTGGTCTGCATAC -> AGGTAGTGGTCTGCATACA
GCTCCGGCTGTGGACTCTC -> CTCCGGCTGTGGACTCTCG
CTCCGCCTGCAGAATCTTA -> TCCGCCTGCAGAATCTTAA
GCATGCGCTCTCGTACCAA -> CATGCGCTCTCGTACCAAG
AGCAGTGGGACCGAGCCCC -> GCAGTGGGACCGAGCCCCA
AGGAACCGTCTAGACCCCG -> GGAACCGTCTAGACCCCGT
CCTGTATACGATCTTTCAT -> CTGTATACGATCTTTCATT
TTCAACTCCCCAAAGCATG -> TCAACTCCCCAAAGCATGC
TCACCGTCGGAAGGTCATA -> CACCGTCGGAAGGTCATAC
GATGTTGATGCAGGAACCG -> ATGTTGATGCAGGAACCGT
TGTGGACTCTCGTGCGGGG -> GTGGACTCTCGTGCGGGGT
AATAGATACGCCACCCACA -> ATAGATACGCCACCCACAG
TGTCAGGCTTTGAGTATGA -> GTCAGGCTTTGAGTATGAA
AAAATAACTATGTACGATA -> AAATAACTATGTACGATAG
AACACCAAGAGTACATGCG -> ACACCAAGAGTACATGCGA
GAGGCACGTTACTCCTCGG -> AGGCACGTTACTCCTCGGG
CATGGTTATCGTGCCTTCG -> ATGGTTATCGTGCCTTCGA
ATTAGACCGATACAGATAC -> TTAGACCGATACAGATACG
AGCCTGTTGCGGTGAGATA -> GCCTGTTGCGGTGAGATAC
GACTCCCGTTATAACGTCC -> ACTCCCGTTATAACGTCCA
ACTCTCATCCTGACCCCTG -> CTCTCATCCTGACCCCTGT
TGTAGTTGGTTTCCACGTA -> GTAGTTGGTTTCCACGTAC
TCGCGCAGACATACGCAGG -> CGCGCAGACATACGCAGGA
GTCTTAGTAAGGAAAAACA -> TCTTAGTAAGGAAAAACAG
GCCAACCCAGTGACCATCC -> CCAACCCAGTGACCATCCC
GACACTCACATTGTGGCAA -> ACACTCACATTGTGGCAAC
CGCGTGTCAGGCTTTGAGT -> GCGTGTCAGGCTTTGAGTA
CGCGTGTCGTGTGACCGTT -> GCGTGTCGTGTGACCGTTA
GAGGGTGTCCGTGCGGTCG -> AGGGTGTCCGTGCGGTCGT
CCTAGCTAGCGCAAAAAAA -> CTAGCTAGCGCAAAAAAAT
GCAAAAAAATGCTTGAATA -> CAAAAAAATGCTTGAATAG
GGCCAATCGGTGCCCAATC -> GCCAATCGGTGCCCAATCC
TGTTGCGGTGAGATACGCC -> GTTGCGGTGAGATACGCCA
GGTTATCGTGCCTTCGAGG -> GTTATCGTGCCTTCGAGGG
TCCATCGTGCTGATGTTGA -> CCATCGTGCTGATGTTGAT
CAAATTTGCTCGTGAACAA -> AAATTTGCTCGTGAACAAT
CATGCGCTCTCGTACCAAG -> ATGCGCTCTCGTACCAAGT
TTTATGATTGGGAGCAAGT -> TTATGATTGGGAGCAAGTA
GTACTACCTCGCTTTAGTC -> TACTACCTCGCTTTAGTCT
GGTAGCTCTCCGCCTGCAG -> GTAGCTCTCCGCCTGCAGA
CCAAGAGTACATGCGAGTC -> CAAGAGTACATGCGAGTCG
AGCCCCCGTTCGTCGACTC -> GCCCCCGTTCGTCGACTCT
AATGGTGAGGCACGTTACT -> ATGGTGAGGCACGTTACTC
TTATATGCCCGTGCGGGCT -> TATATGCCCGTGCGGGCTG
TCCCGTTATAACGTCCATC -> CCCGTTATAACGTCCATCG
TCCCCATTCTGGTGATAGT -> CCCCATTCTGGTGATAGTC
GAACACTCCCTGCAGAACA -> AACACTCCCTGCAGAACAC
TCTAGACCCCGTGTGGATT -> CTAGACCCCGTGTGGATTA
TGGTGATAGTCCCTGTAGT -> GGTGATAGTCCCTGTAGTT
CATCCCTGACTACTAAAAA -> ATCCCTGACTACTAAAAAA
TTAATAGTCGACTCCCGTT -> TAATAGTCGACTCCCGTTT
ACAATGCTTAGCGAAGGAT -> CAATGCTTAGCGAAGGATG
TCTGGAGCTAGGCTTAACT -> CTGGAGCTAGGCTTAACTC
CCTTTAGCCAATATGGCCG -> CTTTAGCCAATATGGCCGA
ATTCTGGCACCCTTGATAT -> TTCTGGCACCCTTGATATA
ACCAAGTTTAGTACTAGCC -> CCAAGTTTAGTACTAGCCC
ATGTTAGTAATTAGGTGAA -> TGTTAGTAATTAGGTGAAT
TTAGCCAATATGGCCGATT -> TAGCCAATATGGCCGATTG
TAAGCCACGACTGATTAAT -> AAGCCACGACTGATTAATG
TCCTCGGGCCGGTACATTT -> CCTCGGGCCGGTACATTTT
TTCTGGGAATTCGACGCTC -> TCTGGGAATTCGACGCTCC
CGTGCCTTCGAGGGTGTCC -> GTGCCTTCGAGGGTGTCCG
CCCCAGGACCTCAGGGGTC -> CCCAGGACCTCAGGGGTCG
TCAACTCCCCAAAGCATGC -> CAACTCCCCAAAGCATGCG
TTATCATTACTCCTGATGC -> TATCATTACTCCTGATGCC
GATTTCCCCAGGACCTCAG -> ATTTCCCCAGGACCTCAGG
ATACACAGCGTGAGTCACC -> TACACAGCGTGAGTCACCG
CCCCATGGTCGCGTGTCAG -> CCCATGGTCGCGTGTCAGG
TGTCGTGTGACCGTTACTT -> GTCGTGTGACCGTTACTTG
ATGACGTTGGCCGATTCTG -> TGACGTTGGCCGATTCTGG
CGTGAACAATGTAGGATAT -> GTGAACAATGTAGGATATT
GGCCGATTGTTAACGTAAA -> GCCGATTGTTAACGTAAAA
TCGCTCAGTTTGGGCAATG -> CGCTCAGTTTGGGCAATGT
TCTCATCCTGACCCCTGTA -> CTCATCCTGACCCCTGTAC
GGTGAGGCACGTTACTCCT -> GTGAGGCACGTTACTCCTC
CTTTCATTTCGTATGGCAT -> TTTCATTTCGTATGGCATT
GGCTGTGGACTCTCGTGCG -> GCTGTGGACTCTCGTGCGG
CGGAGGTCGGTAAAAATAA -> GGAGGTCGGTAAAAATAAC
ATATGAGGCCCGCGAGTGA -> TATGAGGCCCGCGAGTGAT
CTGGAGCTAGGCTTAACTC -> TGGAGCTAGGCTTAACTCA
GCCTCAGCTGAGCAATGCT -> CCTCAGCTGAGCAATGCTG
GATTGTATTCTGGGAATTC -> ATTGTATTCTGGGAATTCG
CGAGTAAATAGTATCCGTT -> GAGTAAATAGTATCCGTTT
GATGCAGGAACCGTCTAGA -> ATGCAGGAACCGTCTAGAC
TTTAGTACTAGCCCTCCCC -> TTAGTACTAGCCCTCCCCA
TGGATTAGACATGATCTTC -> GGATTAGACATGATCTTCA
GTAGACGAGGAAGCATATC -> TAGACGAGGAAGCATATCA
GGTACTGTAGTTATATGCC -> GTACTGTAGTTATATGCCC
TTCTCAAGCGTCGAACACC -> TCTCAAGCGTCGAACACCA
AATCTTAATAGTCGACTCC -> ATCTTAATAGTCGACTCCC
GCGCAAAAAAATGCTTGAA -> CGCAAAAAAATGCTTGAAT
TGAACCTCTTTAGACCCGT -> GAACCTCTTTAGACCCGTT
GTACTCAATTCAGCTTAGA -> TACTCAATTCAGCTTAGAT
GCCCGAGAGAAAATCTTGA -> CCCGAGAGAAAATCTTGAG
TGATGCCGACGCAAATATG -> GATGCCGACGCAAATATGA
ACTGGTGTTCACTTTGAGT -> CTGGTGTTCACTTTGAGTC
ACTGCCCGAGAGAAAATCT -> CTGCCCGAGAGAAAATCTT
TCGAGGGTGTCCGTGCGGT -> CGAGGGTGTCCGTGCGGTC
GGTATGGCTGGTATCTTCA -> GTATGGCTGGTATCTTCAT
ACGACTTTTTGAGGTACTA -> CGACTTTTTGAGGTACTAC
GTGAGATACGCCACCCACA -> TGAGATACGCCACCCACAG
TCAGTGCTTTACCTTATCA -> CAGTGCTTTACCTTATCAT
AATTCAGCTTAGATAGGCC -> ATTCAGCTTAGATAGGCCG
ACTACTTTACACCTTTAGC -> CTACTTTACACCTTTAGCC
TCGTGAACAATGTAGGATA -> CGTGAACAATGTAGGATAT
ACCCCTGTACCATTTCTCA -> CCCCTGTACCATTTCTCAA
GAGTAAATAGTATCCGTTT -> AGTAAATAGTATCCGTTTG
GGACACTCACATTGTGGCA -> GACACTCACATTGTGGCAA
GATCTTCAACTCCCCAAAG -> ATCTTCAACTCCCCAAAGC
CTAAAAAAGCTTGTAGTGC -> TAAAAAAGCTTGTAGTGCG
GTAGTGGTCTGCATACACA -> TAGTGGTCTGCATACACAG
TTACTCCTCGGGCCGGTAC -> TACTCCTCGGGCCGGTACA
CACGACTTTTTGAGGTACT -> ACGACTTTTTGAGGTACTA
CACGTACTCAATTCAGCTT -> ACGTACTCAATTCAGCTTA
GCAACTGGCATACTGCCGC -> CAACTGGCATACTGCCGCC
TCGATCCGGAGGGAAAGGA -> CGATCCGGAGGGAAAGGAT
AGATCACGACTTTTTGAGG -> GATCACGACTTTTTGAGGT
CTTTTAGGTAGTGGTCTGC -> TTTTAGGTAGTGGTCTGCA
TAAACAGGCGACCGTACGA -> AAACAGGCGACCGTACGAT
AAGGATGTCGTACACATGA -> AGGATGTCGTACACATGAT
CCTGTACCATTTCTCAAGC -> CTGTACCATTTCTCAAGCG
ACACAGCGTGGCCTGTATA -> CACAGCGTGGCCTGTATAC
CAGCAAGAGGACAGCGGTC -> AGCAAGAGGACAGCGGTCT
CGACTCCCGTTTGAACCCG -> GACTCCCGTTTGAACCCGT
ATCTTGAGAACACTCCCTG -> TCTTGAGAACACTCCCTGC
ATATCGTCTAAACAGGCGA -> TATCGTCTAAACAGGCGAC
CATTTCGTATGGCATTAAA -> ATTTCGTATGGCATTAAAC
CACACTGGTGTTCACTTTG -> ACACTGGTGTTCACTTTGA
TTAGTAATTAGGTGAATTG -> TAGTAATTAGGTGAATTGG
AGTTCTACTGCCCGAGAGA -> GTTCTACTGCCCGAGAGAA
GAGTCACCGTCGGAAGGTC -> AGTCACCGTCGGAAGGTCA
CTGCCGCCTCCATGGCTTC -> TGCCGCCTCCATGGCTTCG
AGCGTGCGGTCTGCATACA -> GCGTGCGGTCTGCATACAC
GAAGAACTTATGCTTACAA -> AAGAACTTATGCTTACAAC
GACCCTCTCGGATCTGTCT -> ACCCTCTCGGATCTGTCTT
AAGAGGACAGCGGTCTGCA -> AGAGGACAGCGGTCTGCAT
ATATGTACGGAGGTCGGTA -> TATGTACGGAGGTCGGTAA
GCATACACAGCGTGCGGTC -> CATACACAGCGTGCGGTCT
TAGTTATATGCCCGTGCGG -> AGTTATATGCCCGTGCGGG
CAGCTTTTAGGTAGTGGTC -> AGCTTTTAGGTAGTGGTCT
ACGTTACTCCTCGGGCCGG -> CGTTACTCCTCGGGCCGGT
TGTTAACGTAAAATGGGCG -> GTTAACGTAAAATGGGCGA
AGCCCCGCTTTGATGTGGC -> GCCCCGCTTTGATGTGGCC
AGTGGGACCGAGCCCCATG -> GTGGGACCGAGCCCCATGA
CCGACATTGAACTGAGACG -> CGACATTGAACTGAGACGC
CGATAGGTAGACGAGGAAG -> GATAGGTAGACGAGGAAGC
AGCGGTCTGCATACACAGC -> GCGGTCTGCATACACAGCG
TTTAGCCAATATGGCCGAT -> TTAGCCAATATGGCCGATT
GCAAGCCAGCTAATGACCC -> CAAGCCAGCTAATGACCCT
GGCATTAAACGCTGAACAG -> GCATTAAACGCTGAACAGT
GTCGTACACATGATTTCGC -> TCGTACACATGATTTCGCG
GAGTACATGCGAGTCGAAC -> AGTACATGCGAGTCGAACT
TACACAGCGTGCGGTCTGC -> ACACAGCGTGCGGTCTGCA
GATACGCCACCCACAGCCT -> ATACGCCACCCACAGCCTG
CCATTTCTCAAGCGTCGAA -> CATTTCTCAAGCGTCGAAC
CGCCTGCAGAATCTTAATA -> GCCTGCAGAATCTTAATAG
CACTTTGAGTCTTAGTAAG -> ACTTTGAGTCTTAGTAAGG
ACGCCACCCACAGCTTTTA -> CGCCACCCACAGCTTTTAG
ATGATTTCGCGCAGACATA -> TGATTTCGCGCAGACATAC
GCGTTGTAAGGCTATCATA -> CGTTGTAAGGCTATCATAT
TGAGATACGCCACCCACAG -> GAGATACGCCACCCACAGC
TGATCACCATCCCCTAGCT -> GATCACCATCCCCTAGCTA
ATGGGCGAATGACACGCGA -> TGGGCGAATGACACGCGAG
CATACACAGCGTGCCAACC -> ATACACAGCGTGCCAACCC
CGAAGAACTTATGCTTACA -> GAAGAACTTATGCTTACAA
ACTGAGACGCTGTGTGGAT -> CTGAGACGCTGTGTGGATA
TCGGATCTGTCTTGCCTAC -> CGGATCTGTCTTGCCTACC
CTTATCATTACTCCTGATG -> TTATCATTACTCCTGATGC
CTTAACTCACACCAACACA -> TTAACTCACACCAACACAC
AGACGAGGAAGCATATCAT -> GACGAGGAAGCATATCATC
ACGATCAAGGGCCGGGATT -> CGATCAAGGGCCGGGATTA
GTGCGGGGTTATGACTTGT -> TGCGGGGTTATGACTTGTT
ACTCAATTCAGCTTAGATA -> CTCAATTCAGCTTAGATAG
TCCCTGACTACTAAAAAAG -> CCCTGACTACTAAAAAAGC
ACTTTTTGAGGTACTACCT -> CTTTTTGAGGTACTACCTC
AGCGTGAGTCACCGTCGGA -> GCGTGAGTCACCGTCGGAA
CTTTGTAGCCATCACTATG -> TTTGTAGCCATCACTATGA
ATTTGCTCGTGAACAATGT -> TTTGCTCGTGAACAATGTA
CACACAGTTCTACTGCCCG -> ACACAGTTCTACTGCCCGA
ACATGATCTTCAACTCCCC -> CATGATCTTCAACTCCCCA
TACTCTAGAGAAGCGCTCG -> ACTCTAGAGAAGCGCTCGC
CCGTCTAGATTTCCCCAGG -> CGTCTAGATTTCCCCAGGA
ATAAAGCGTCTCATGGTTA -> TAAAGCGTCTCATGGTTAT
CGTTGTAAGGCTATCATAT -> GTTGTAAGGCTATCATATC
TGACATAACTAGACCCAGA -> GACATAACTAGACCCAGAC
TTACGATCAAGGGCCGGGA -> TACGATCAAGGGCCGGGAT
TCTAGATTTCCCCAGGACC -> CTAGATTTCCCCAGGACCT
ATCATTACTCCTGATGCCG -> TCATTACTCCTGATGCCGA
AGACATACGCAGGAACCCG -> GACATACGCAGGAACCCGG
GACGTCCCGGTAGCTCTCC -> ACGTCCCGGTAGCTCTCCG
ATATCATCGGTACCCCCAT -> TATCATCGGTACCCCCATG
AGTAAGCCACGACTGATTA -> GTAAGCCACGACTGATTAA
TCTTAGTAAGGAAAAACAG -> CTTAGTAAGGAAAAACAGG
TACTAAAAAAGCTTGTAGT -> ACTAAAAAAGCTTGTAGTG
TAGTAGGACAGTCCCAAAA -> AGTAGGACAGTCCCAAAAT
TGCCTTCATCGGCAGTGAT -> GCCTTCATCGGCAGTGATG
GTACTGTAGTTATATGCCC -> TACTGTAGTTATATGCCCG
CCCAGGACCTCAGGGGTCG -> CCAGGACCTCAGGGGTCGA
TGATAGTCCCTGTAGTTGG -> GATAGTCCCTGTAGTTGGT
TTGTTTCGCCTCAGCTGAG -> TGTTTCGCCTCAGCTGAGC
TGCTGCTTTTATCCCCACA -> GCTGCTTTTATCCCCACAC
GCTCTCGTACCAAGTTTAG -> CTCTCGTACCAAGTTTAGT
TAACGTCCATCGTGCTGAT -> AACGTCCATCGTGCTGATG
ACACACTGGTGTTCACTTT -> CACACTGGTGTTCACTTTG
TTGGCCGATTCTGGCACCC -> TGGCCGATTCTGGCACCCT
TCCTGACCCCTGTACCATT -> CCTGACCCCTGTACCATTT
CCCAGACAATGCTTAGCGA -> CCAGACAATGCTTAGCGAA
TGATTTCCGAAGAACTTAT -> GATTTCCGAAGAACTTATG
TTTGGTATGGCTGGTATCT -> TTGGTATGGCTGGTATCTT
CCACGACTGATTAATGGTG -> CACGACTGATTAATGGTGA
TATGGCCGATTGTTAACGT -> ATGGCCGATTGTTAACGTA
AAAACAGGTCTAGATTAAG -> AAACAGGTCTAGATTAAGG
AGACGCTGTGTGGATAAGC -> GACGCTGTGTGGATAAGCC
ACTGCCGCCTCCATGGCTT -> CTGCCGCCTCCATGGCTTC
AACCGTCTAGACCCCGTGT -> ACCGTCTAGACCCCGTGTG
GCCTCCATGGCTTCGAACA -> CCTCCATGGCTTCGAACAG
AAACGCTGAACAGTCGGCT -> AACGCTGAACAGTCGGCTG
CCAAGATACGCCACCCACA -> CAAGATACGCCACCCACAG
TATGCTTACAACTTCATTG -> ATGCTTACAACTTCATTGA
GCGCTAGCAACACCCACTT -> CGCTAGCAACACCCACTTG
TGGGGTTGGCATGTGATAT -> GGGGTTGGCATGTGATATG
ACAGCCTGTTGCGGTGAGA -> CAGCCTGTTGCGGTGAGAT
ACGTAAAATGGGCGAATGA -> CGTAAAATGGGCGAATGAC
GAGTGTGACTCCCGTTATA -> AGTGTGACTCCCGTTATAA
TAGCAACACCCACTTGTTA -> AGCAACACCCACTTGTTAC
GAGCAAGTATAAAGCGTCT -> AGCAAGTATAAAGCGTCTC
CCGGGATTAGACCGATACA -> CGGGATTAGACCGATACAG
CAACACTTCAGTGCTTTAC -> AACACTTCAGTGCTTTACC
GAGTGATAAAGTCTGGAGC -> AGTGATAAAGTCTGGAGCT
ACTTCATTGACATAACTAG -> CTTCATTGACATAACTAGA
AGGGCCGGGATTAGACCGA -> GGGCCGGGATTAGACCGAT
TTTTATGATTGGGAGCAAG -> TTTATGATTGGGAGCAAGT
CCCGTTCGTCGACTCTTGC -> CCGTTCGTCGACTCTTGCC
AGCCAGCTAATGACCCTCT -> GCCAGCTAATGACCCTCTC
CATACGCAGGAACCCGGGA -> ATACGCAGGAACCCGGGAC
GGTCGGTAAAAATAACTAT -> GTCGGTAAAAATAACTATG
GTTCGTCGACTCTTGCCTT -> TTCGTCGACTCTTGCCTTC
CTACCTTGTTTCGCCTCAG -> TACCTTGTTTCGCCTCAGC
GTTACCAGTACAGGTACTG -> TTACCAGTACAGGTACTGT
GGAGCAAGTATAAAGCGTC -> GAGCAAGTATAAAGCGTCT
TAAGGGTACATACTCTCAT -> AAGGGTACATACTCTCATC
TAGTACTAGCCCTCCCCAG -> AGTACTAGCCCTCCCCAGT
TTTATCCCCACACAGTTCT -> TTATCCCCACACAGTTCTA
GCGGTGAGATACGCCACCC -> CGGTGAGATACGCCACCCA
ACACTTCAGTGCTTTACCT -> CACTTCAGTGCTTTACCTT
GTACATGCGAGTCGAACTG -> TACATGCGAGTCGAACTGC
ATCCGGAGGGAAAGGATTG -> TCCGGAGGGAAAGGATTGT
AGAGAAGCGCTCGCAACAC -> GAGAAGCGCTCGCAACACT
ATGAGGAATAGACCAAGAT -> TGAGGAATAGACCAAGATA
ATCCCCACACAGTTCTACT -> TCCCCACACAGTTCTACTG
TGCTGATGTTGATGCAGGA -> GCTGATGTTGATGCAGGAA
CCGTTTGATCACCATCCCC -> CGTTTGATCACCATCCCCT
CCTCGGGCCGTCAATCGAT -> CTCGGGCCGTCAATCGATC
TATGGCATTAAACGCTGAA -> ATGGCATTAAACGCTGAAC
GAAGGATGTCGTACACATG -> AAGGATGTCGTACACATGA
GCGTGCGGTCTGCATACAC -> CGTGCGGTCTGCATACACA
CTTTACCTTATCATTACTC -> TTTACCTTATCATTACTCC
CCTGACTACTAAAAAAGCT -> CTGACTACTAAAAAAGCTT
CCCAATCCCAATCGAGTAA -> CCAATCCCAATCGAGTAAA
CCCCCATGGTCGCGTGTCA -> CCCCATGGTCGCGTGTCAG
CGCTCTCGTACCAAGTTTA -> GCTCTCGTACCAAGTTTAG
TAGGATATTTTACGATCAA -> AGGATATTTTACGATCAAG
GGCATACTGCCGCCTCCAT -> GCATACTGCCGCCTCCATG
ATCGGTACCCCCATGGTCG -> TCGGTACCCCCATGGTCGC
GGTCTGCATACACAGCGTG -> GTCTGCATACACAGCGTGC,GTCTGCATACACAGCGTGA,GTCTGCATACACAGCGTGC,GTCTGCATACACAGCGTGG
GATCGCTCAGTTTGGGCAA -> ATCGCTCAGTTTGGGCAAT
AAAATTAAAAGCCCCGCTT -> AAATTAAAAGCCCCGCTTT
TGATCTTCAACTCCCCAAA -> GATCTTCAACTCCCCAAAG
AGTGGTCTGCATACACAGC -> GTGGTCTGCATACACAGCG
AAATAGTATCCGTTTGGTA -> AATAGTATCCGTTTGGTAT
ATTGTGGCAACTGGCATAC -> TTGTGGCAACTGGCATACT
ATACGCCACCCACAGCGTT -> TACGCCACCCACAGCGTTG
TGAGTGTGACTCCCGTTAT -> GAGTGTGACTCCCGTTATA
GCAGGACACACCTGCGTTG -> CAGGACACACCTGCGTTGT
GTATACGATCTTTCATTTC -> TATACGATCTTTCATTTCG
GCGCTCGCAACACTTCAGT -> CGCTCGCAACACTTCAGTG
CACCAAGAGTACATGCGAG -> ACCAAGAGTACATGCGAGT
ACAGGTACTGTAGTTATAT -> CAGGTACTGTAGTTATATG
AGGTACTACCTCGCTTTAG -> GGTACTACCTCGCTTTAGT
TGCCCAATCCCAATCGAGT -> GCCCAATCCCAATCGAGTA
TGATTAATGGTGAGGCACG -> GATTAATGGTGAGGCACGT
TTGATGTGGCCAATCGGTG -> TGATGTGGCCAATCGGTGC
CGTTACTCCTCGGGCCGGT -> GTTACTCCTCGGGCCGGTA
TGGCCGATTCTGGCACCCT -> GGCCGATTCTGGCACCCTT
TGCCGCCTCCATGGCTTCG -> GCCGCCTCCATGGCTTCGA
AGCCCCATGAGGAATAGAC -> GCCCCATGAGGAATAGACC
CTGACTACTAAAAAAGCTT -> TGACTACTAAAAAAGCTTG
GTCTGCTGCTTTTATCCCC -> TCTGCTGCTTTTATCCCCA
AACTTCATTGACATAACTA -> ACTTCATTGACATAACTAG
AAAATCTTGAGAACACTCC -> AAATCTTGAGAACACTCCC
GACATACGCAGGAACCCGG -> ACATACGCAGGAACCCGGG
AGTTGGTTTCCACGTACTC -> GTTGGTTTCCACGTACTCA
CAGGACCTCAGGGGTCGAC -> AGGACCTCAGGGGTCGACG
CAAATATGAGGCCCGCGAG -> AAATATGAGGCCCGCGAGT
CTGGTGATAGTCCCTGTAG -> TGGTGATAGTCCCTGTAGT
AGTGACCATCCCTGACTAC -> GTGACCATCCCTGACTACT
CCCATGAGGAATAGACCAA -> CCATGAGGAATAGACCAAG
GTGAACAATGTAGGATATT -> TGAACAATGTAGGATATTT
TCTTGCCTACCTTGTTTCG -> CTTGCCTACCTTGTTTCGC
GGATCTGTCTTGCCTACCT -> GATCTGTCTTGCCTACCTT
CAGCCCCCGTTCGTCGACT -> AGCCCCCGTTCGTCGACTC
GTATGGCATTAAACGCTGA -> TATGGCATTAAACGCTGAA
AGTAGGACAGTCCCAAAAT -> GTAGGACAGTCCCAAAATT
CAGGAACCGTCTAGACCCC -> AGGAACCGTCTAGACCCCG
TTCGTATGGCATTAAACGC -> TCGTATGGCATTAAACGCT
CACATTGTGGCAACTGGCA -> ACATTGTGGCAACTGGCAT
GAAAAACAGGTCTAGATTA -> AAAAACAGGTCTAGATTAA
GATATAGTAGGACAGTCCC -> ATATAGTAGGACAGTCCCA
ATTGGGAGCAAGTATAAAG -> TTGGGAGCAAGTATAAAGC
ATTAAAAGCCCCGCTTTGA -> TTAAAAGCCCCGCTTTGAT
TCAGGCTTTGAGTATGAAC -> CAGGCTTTGAGTATGAACC
CACAGCGTGAGTCACCGTC -> ACAGCGTGAGTCACCGTCG
TGAATTGGAATAGATACGC -> GAATTGGAATAGATACGCC
GAACCCGGGACACTCACAT -> AACCCGGGACACTCACATT
TCATCGGTACCCCCATGGT -> CATCGGTACCCCCATGGTC
TCAGTTTGGGCAATGTCAA -> CAGTTTGGGCAATGTCAAA
GCTTACAACTTCATTGACA -> CTTACAACTTCATTGACAT
CTCTCGTGCGGGGTTATGA -> TCTCGTGCGGGGTTATGAC
ATCGTCTAAACAGGCGACC -> TCGTCTAAACAGGCGACCG
CTAGATTTCCCCAGGACCT -> TAGATTTCCCCAGGACCTC
CATCCTGACCCCTGTACCA -> ATCCTGACCCCTGTACCAT
CTCGCTTTAGTCTCGACGT -> TCGCTTTAGTCTCGACGTC
TGGCTTCGAACAGGACATG -> GGCTTCGAACAGGACATGC
CGTCTAGATTTCCCCAGGA -> GTCTAGATTTCCCCAGGAC
GAGTATGAACCTCTTTAGA -> AGTATGAACCTCTTTAGAC
TGTGGCCAATCGGTGCCCA -> GTGGCCAATCGGTGCCCAA
ATTAATGGTGAGGCACGTT -> TTAATGGTGAGGCACGTTA
TCTGGTGATAGTCCCTGTA -> CTGGTGATAGTCCCTGTAG
CGGTAGCTCTCCGCCTGCA -> GGTAGCTCTCCGCCTGCAG
GTAAGGCTATCATATCGTC -> TAAGGCTATCATATCGTCT
CCCCGTTCGTCGACTCTTG -> CCCGTTCGTCGACTCTTGC
GGAAAAACAGGTCTAGATT -> GAAAAACAGGTCTAGATTA
ACTAGACCCAGACAATGCT -> CTAGACCCAGACAATGCTT
CTTGTAGTGCGCTAGCAAC -> TTGTAGTGCGCTAGCAACA
TTACCAGTACAGGTACTGT -> TACCAGTACAGGTACTGTA
CCTTGTTTCGCCTCAGCTG -> CTTGTTTCGCCTCAGCTGA
CCGCCTCCATGGCTTCGAA -> CGCCTCCATGGCTTCGAAC
CTACTGCCCGAGAGAAAAT -> TACTGCCCGAGAGAAAATC
CTTTGAGTATGAACCTCTT -> TTTGAGTATGAACCTCTTT
AGAAGCGCTCGCAACACTT -> GAAGCGCTCGCAACACTTC
TTTCCGAAGAACTTATGCT -> TTCCGAAGAACTTATGCTT
TGCCCGTGCGGGCTGACCC -> GCCCGTGCGGGCTGACCCA
CTCGCAACACTTCAGTGCT -> TCGCAACACTTCAGTGCTT
CTTGAATAGATTAAATCCT -> TTGAATAGATTAAATCCTC
ACCAGTACAGGTACTGTAG -> CCAGTACAGGTACTGTAGT
CGATCGCTCAGTTTGGGCA -> GATCGCTCAGTTTGGGCAA
ACGTACTCAATTCAGCTTA -> CGTACTCAATTCAGCTTAG
GTTCACTTTGAGTCTTAGT -> TTCACTTTGAGTCTTAGTA
TAGCTCTCCGCCTGCAGAA -> AGCTCTCCGCCTGCAGAAT
TTGTAGTGCGCTAGCAACA -> TGTAGTGCGCTAGCAACAC
TCGACTCTTGCCTTCATCG -> CGACTCTTGCCTTCATCGG
GTGGATTAGACATGATCTT -> TGGATTAGACATGATCTTC
CAATGCTGGGGTTGGCATG -> AATGCTGGGGTTGGCATGT
GGTGTTCACTTTGAGTCTT -> GTGTTCACTTTGAGTCTTA
TTGAACCCGTGTCTGCTGC -> TGAACCCGTGTCTGCTGCT
CACCGTCGGAAGGTCATAC -> ACCGTCGGAAGGTCATACT
CTGCAGAATCTTAATAGTC -> TGCAGAATCTTAATAGTCG
CCCATGGTCGCGTGTCAGG -> CCATGGTCGCGTGTCAGGC
CAGGTCTAGATTAAGGGTA -> AGGTCTAGATTAAGGGTAC
GCCTTCATCGGCAGTGATG -> CCTTCATCGGCAGTGATGA
CTCGTACCAAGTTTAGTAC -> TCGTACCAAGTTTAGTACT
TTGAATAGATTAAATCCTC -> TGAATAGATTAAATCCTCG
TACATGCGAGTCGAACTGC -> ACATGCGAGTCGAACTGCA
GACCGAGCCCCATGAGGAA -> ACCGAGCCCCATGAGGAAT
GGGATTAGACCGATACAGA -> GGATTAGACCGATACAGAT
TTTCCCCAGGACCTCAGGG -> TTCCCCAGGACCTCAGGGG
AGCTTTTAGGTAGTGGTCT -> GCTTTTAGGTAGTGGTCTG
CGAACAGGACATGCCCAAA -> GAACAGGACATGCCCAAAT
AACAGGCGACCGTACGATC -> ACAGGCGACCGTACGATCG
TGAGTCACCGTCGGAAGGT -> GAGTCACCGTCGGAAGGTC
CGTCAATCGATCCGGAGGG -> GTCAATCGATCCGGAGGGA
ATTAAACGCTGAACAGTCG -> TTAAACGCTGAACAGTCGG
ACACTCCCTGCAGAACACA -> CACTCCCTGCAGAACACAG
TTATGCTTACAACTTCATT -> TATGCTTACAACTTCATTG
GTGCGGTCGTGATTTCCCC -> TGCGGTCGTGATTTCCCCA
CCCAGTGACCATCCCTGAC -> CCAGTGACCATCCCTGACT
ATAAGTAAGCCACGACTGA -> TAAGTAAGCCACGACTGAT
GGGTCGACGGTGCAGGACA -> GGTCGACGGTGCAGGACAC
CAGTCTTCATAAGTAAGCC -> AGTCTTCATAAGTAAGCCA
ACTGTAGTTATATGCCCGT -> CTGTAGTTATATGCCCGTG
GATACAGATACGCCACCCA -> ATACAGATACGCCACCCAC
GCCGATTGTTAACGTAAAA -> CCGATTGTTAACGTAAAAT
CATACTCTCATCCTGACCC -> ATACTCTCATCCTGACCCC
ACTGATTAATGGTGAGGCA -> CTGATTAATGGTGAGGCAC
TAGAGAAGCGCTCGCAACA -> AGAGAAGCGCTCGCAACAC
TGGTGTTCACTTTGAGTCT -> GGTGTTCACTTTGAGTCTT
TATCAGTCTAAGATCACGA -> ATCAGTCTAAGATCACGAC
TACCATTTCTCAAGCGTCG -> ACCATTTCTCAAGCGTCGA
TCAGGGGTCGACGGTGCAG -> CAGGGGTCGACGGTGCAGG
GGAGCTAGGCTTAACTCAC -> GAGCTAGGCTTAACTCACA
CGGAAGGTCATACTCTAGA -> GGAAGGTCATACTCTAGAG
ATGCGAGTCGAACTGCAGC -> TGCGAGTCGAACTGCAGCC
TCGTGCCTTCGAGGGTGTC -> CGTGCCTTCGAGGGTGTCC
GATCAAGGGCCGGGATTAG -> ATCAAGGGCCGGGATTAGA
CGTACACATGATTTCGCGC -> GTACACATGATTTCGCGCA
GGTAGACGAGGAAGCATAT -> GTAGACGAGGAAGCATATC
GAGTCTTAGTAAGGAAAAA -> AGTCTTAGTAAGGAAAAAC
TCTAAGATCACGACTTTTT -> CTAAGATCACGACTTTTTG
TCCCCACACAGTTCTACTG -> CCCCACACAGTTCTACTGC
CACAGCTTTTAGGTAGTGG -> ACAGCTTTTAGGTAGTGGT
ATTTCCCCAGGACCTCAGG -> TTTCCCCAGGACCTCAGGG
GATAGGTAGACGAGGAAGC -> ATAGGTAGACGAGGAAGCA
AGCGTTGAATTTGGGGTCT -> GCGTTGAATTTGGGGTCTG
TCGTACCAAGTTTAGTACT -> CGTACCAAGTTTAGTACTA
GTCTTCATAAGTAAGCCAC -> TCTTCATAAGTAAGCCACG
TCGACGCTCCGGCTGTGGA -> CGACGCTCCGGCTGTGGAC
CGAGTCGAACTGCAGCCCC -> GAGTCGAACTGCAGCCCCC
CCCAGTCTTCATAAGTAAG -> CCAGTCTTCATAAGTAAGC
ATAGTAGGACAGTCCCAAA -> TAGTAGGACAGTCCCAAAA
CCCAAAGCATGCGCTCTCG -> CCAAAGCATGCGCTCTCGT
ATCTTCAACTCCCCAAAGC -> TCTTCAACTCCCCAAAGCA
ACTCCCTGCAGAACACAGC -> CTCCCTGCAGAACACAGCA
GTCGAACACCAAGAGTACA -> TCGAACACCAAGAGTACAT
ACACAGCGTGAGTCACCGT -> CACAGCGTGAGTCACCGTC
GGAATAGATACGCCACCCA -> GAATAGATACGCCACCCAC
AGCCATCACTATGACGTTG -> GCCATCACTATGACGTTGG
TGCGCTAGCAACACCCACT -> GCGCTAGCAACACCCACTT
CTCAATTCAGCTTAGATAG -> TCAATTCAGCTTAGATAGG
CCATCCCTGACTACTAAAA -> CATCCCTGACTACTAAAAA
AGACATGATCTTCAACTCC -> GACATGATCTTCAACTCCC
GTAAAATGGGCGAATGACA -> TAAAATGGGCGAATGACAC
GTGTGGATTAGACATGATC -> TGTGGATTAGACATGATCT
TCTAGATTAAGGGTACATA -> CTAGATTAAGGGTACATAC
TTTTATCCCCACACAGTTC -> TTTATCCCCACACAGTTCT
TAAATAGTATCCGTTTGGT -> AAATAGTATCCGTTTGGTA
CACTCCCTGCAGAACACAG -> ACTCCCTGCAGAACACAGC
GCTAATGACCCTCTCGGAT -> CTAATGACCCTCTCGGATC
TGCTTAGCGAAGGATGTCG -> GCTTAGCGAAGGATGTCGT
ACAGCAGTGGGACCGAGCC -> CAGCAGTGGGACCGAGCCC
TTAACGTAAAATGGGCGAA -> TAACGTAAAATGGGCGAAT
CAACACACTGGTGTTCACT -> AACACACTGGTGTTCACTT
AGAGTACATGCGAGTCGAA -> GAGTACATGCGAGTCGAAC
AAGCCAGCTAATGACCCTC -> AGCCAGCTAATGACCCTCT
AGGGTACATACTCTCATCC -> GGGTACATACTCTCATCCT
TAATGACCCTCTCGGATCT -> AATGACCCTCTCGGATCTG
AGGCTATCATATCGTCTAA -> GGCTATCATATCGTCTAAA
AATTAATCCGCGTGTCGTG -> ATTAATCCGCGTGTCGTGT
CCCGTTTGAACCCGTGTCT -> CCGTTTGAACCCGTGTCTG
GCTGAACAGTCGGCTGGCA -> CTGAACAGTCGGCTGGCAA
CTGACCCCTGTACCATTTC -> TGACCCCTGTACCATTTCT
GTGCGGTCTGCATACACAG -> TGCGGTCTGCATACACAGC
AGGCGACCGTACGATCGCT -> GGCGACCGTACGATCGCTC
GGATTGTATTCTGGGAATT -> GATTGTATTCTGGGAATTC
GACCGTTACTTGAGTGTGA -> ACCGTTACTTGAGTGTGAC
AAGTCTGGAGCTAGGCTTA -> AGTCTGGAGCTAGGCTTAA
CTGTATACGATCTTTCATT -> TGTATACGATCTTTCATTT
GAAGGTCATACTCTAGAGA -> AAGGTCATACTCTAGAGAA
CCGGGACACTCACATTGTG -> CGGGACACTCACATTGTGG
AATGTCAAATTTGCTCGTG -> ATGTCAAATTTGCTCGTGA
TATCGTGCCTTCGAGGGTG -> ATCGTGCCTTCGAGGGTGT
TAGACCCAGACAATGCTTA -> AGACCCAGACAATGCTTAG
GTGGATAAGCCGGATCTAT -> TGGATAAGCCGGATCTATC
CAGCCTGTTGCGGTGAGAT -> AGCCTGTTGCGGTGAGATA
TACTCTCATCCTGACCCCT -> ACTCTCATCCTGACCCCTG
TCTCGGATCTGTCTTGCCT -> CTCGGATCTGTCTTGCCTA
AACTCACACCAACACACTG -> ACTCACACCAACACACTGG
GTCGACTCTTGCCTTCATC -> TCGACTCTTGCCTTCATCG
TGAGGAATAGACCAAGATA -> GAGGAATAGACCAAGATAC
ATCATATCGTCTAAACAGG -> TCATATCGTCTAAACAGGC
GTCGGAAGGTCATACTCTA -> TCGGAAGGTCATACTCTAG
GTCGGTAAAAATAACTATG -> TCGGTAAAAATAACTATGT
ATCTTAATAGTCGACTCCC -> TCTTAATAGTCGACTCCCG
CCACCCACAGCGTTGAATT -> CACCCACAGCGTTGAATTT
GTACATTTTATGATTGGGA -> TACATTTTATGATTGGGAG
AGAGAAAATCTTGAGAACA -> GAGAAAATCTTGAGAACAC
ATTTTACGATCAAGGGCCG -> TTTTACGATCAAGGGCCGG
GGGCCGTCAATCGATCCGG -> GGCCGTCAATCGATCCGGA
TAGATAGGCCGACATTGAA -> AGATAGGCCGACATTGAAC
CTCCCGTTTGAACCCGTGT -> TCCCGTTTGAACCCGTGTC
GATACGCCACCCACAGCAA -> ATACGCCACCCACAGCAAG
TGGCATGTGATATGTACGG -> GGCATGTGATATGTACGGA
TACGCAGGAACCCGGGACA -> ACGCAGGAACCCGGGACAC
ATGGCATTAAACGCTGAAC -> TGGCATTAAACGCTGAACA
GGCCGGTACATTTTATGAT -> GCCGGTACATTTTATGATT
ACAGATACGCCACCCACAG -> CAGATACGCCACCCACAGC
TAGACCGATACAGATACGC -> AGACCGATACAGATACGCC
GTATAAAGCGTCTCATGGT -> TATAAAGCGTCTCATGGTT
CGTCCCGGTAGCTCTCCGC -> GTCCCGGTAGCTCTCCGCC
CAATCGATCCGGAGGGAAA -> AATCGATCCGGAGGGAAAG
CTTGATATAGTAGGACAGT -> TTGATATAGTAGGACAGTC
TTGGTATGGCTGGTATCTT -> TGGTATGGCTGGTATCTTC
GCTCTCCGCCTGCAGAATC -> CTCTCCGCCTGCAGAATCT
CGTCGACTCTTGCCTTCAT -> GTCGACTCTTGCCTTCATC
GACAGCGGTCTGCATACAC -> ACAGCGGTCTGCATACACA
CGATTCTGGCACCCTTGAT -> GATTCTGGCACCCTTGATA
GAATTGGAATAGATACGCC -> AATTGGAATAGATACGCCA
CTCGGGCCGTCAATCGATC -> TCGGGCCGTCAATCGATCC
GTGATAAAGTCTGGAGCTA -> TGATAAAGTCTGGAGCTAG
GACCCACTACTTTACACCT -> ACCCACTACTTTACACCTT
GGACACACCTGCGTTGTAA -> GACACACCTGCGTTGTAAG
TAGATTTCCCCAGGACCTC -> AGATTTCCCCAGGACCTCA
ACTCCTGATGCCGACGCAA -> CTCCTGATGCCGACGCAAA
AATAGTATCCGTTTGGTAT -> ATAGTATCCGTTTGGTATG
GCGCAGACATACGCAGGAA -> CGCAGACATACGCAGGAAC
GGACCTCAGGGGTCGACGG -> GACCTCAGGGGTCGACGGT
GACAGTCCCAAAATTAAAA -> ACAGTCCCAAAATTAAAAG
TCCATGGCTTCGAACAGGA -> CCATGGCTTCGAACAGGAC
CCTCTTTAGACCCGTTTGA -> CTCTTTAGACCCGTTTGAT
ATCGTGCTGATGTTGATGC -> TCGTGCTGATGTTGATGCA
TGCGCTCTCGTACCAAGTT -> GCGCTCTCGTACCAAGTTT
CAGTTCTACTGCCCGAGAG -> AGTTCTACTGCCCGAGAGA
CAGCTTAGATAGGCCGACA -> AGCTTAGATAGGCCGACAT
TCACCATCCCCTAGCTAGC -> CACCATCCCCTAGCTAGCG
CGACTGATTAATGGTGAGG -> GACTGATTAATGGTGAGGC
CGTCTAGACCCCGTGTGGA -> GTCTAGACCCCGTGTGGAT
AGATACGCCACCCACAGCA -> GATACGCCACCCACAGCAA
AGATACGCCACCCACAGCC -> GATACGCCACCCACAGCCT
TGTTCCCGTCTAGATTTCC -> GTTCCCGTCTAGATTTCCC
CTCTTTAGACCCGTTTGAT -> TCTTTAGACCCGTTTGATC
AGATACGCCACCCACAGCG -> GATACGCCACCCACAGCGT
TCATGTTAGTAATTAGGTG -> CATGTTAGTAATTAGGTGA
TACCTCGCTTTAGTCTCGA -> ACCTCGCTTTAGTCTCGAC
CGACTCTTGCCTTCATCGG -> GACTCTTGCCTTCATCGGC
CGTCGGAAGGTCATACTCT -> GTCGGAAGGTCATACTCTA
TGTGACTCCCGTTATAACG -> GTGACTCCCGTTATAACGT
GGTGATAGTCCCTGTAGTT -> GTGATAGTCCCTGTAGTTG
CACAGTTCTACTGCCCGAG -> ACAGTTCTACTGCCCGAGA
AAGCGTCTCATGGTTATCG -> AGCGTCTCATGGTTATCGT
GACTACTAAAAAAGCTTGT -> ACTACTAAAAAAGCTTGTA
AAAAAATGCTTGAATAGAT -> AAAAATGCTTGAATAGATT
CCCGGTAGCTCTCCGCCTG -> CCGGTAGCTCTCCGCCTGC
TGGAGCTAGGCTTAACTCA -> GGAGCTAGGCTTAACTCAC
GTTGGTTTCCACGTACTCA -> TTGGTTTCCACGTACTCAA
ACAGCGTGAGTCACCGTCG -> CAGCGTGAGTCACCGTCGG
ATTGTTAACGTAAAATGGG -> TTGTTAACGTAAAATGGGC
AGGACAGTCCCAAAATTAA -> GGACAGTCCCAAAATTAAA
ATTAAATCCTCGGGCCGTC -> TTAAATCCTCGGGCCGTCA
CTTCAACTCCCCAAAGCAT -> TTCAACTCCCCAAAGCATG
ACTCCCCAAAGCATGCGCT -> CTCCCCAAAGCATGCGCTC
AATTCGACGCTCCGGCTGT -> ATTCGACGCTCCGGCTGTG
GGGTTGGCATGTGATATGT -> GGTTGGCATGTGATATGTA
AAGCATATCATCGGTACCC -> AGCATATCATCGGTACCCC
ATTCTGGTGATAGTCCCTG -> TTCTGGTGATAGTCCCTGT
GTTCTACTGCCCGAGAGAA -> TTCTACTGCCCGAGAGAAA
AAGAGTACATGCGAGTCGA -> AGAGTACATGCGAGTCGAA
AATCTTGAGAACACTCCCT -> ATCTTGAGAACACTCCCTG
CATCCCCTAGCTAGCGCAA -> ATCCCCTAGCTAGCGCAAA
CGATCCGGAGGGAAAGGAT -> GATCCGGAGGGAAAGGATT
TGGCAAGCCAGCTAATGAC -> GGCAAGCCAGCTAATGACC
CTCCCCAAAGCATGCGCTC -> TCCCCAAAGCATGCGCTCT
CACCCACAGCCTGTTGCGG -> ACCCACAGCCTGTTGCGGT
TTCTGGTGATAGTCCCTGT -> TCTGGTGATAGTCCCTGTA
TGAGAACACTCCCTGCAGA -> GAGAACACTCCCTGCAGAA
GCCCGCGAGTGATAAAGTC -> CCCGCGAGTGATAAAGTCT
CGGGCCGTCAATCGATCCG -> GGGCCGTCAATCGATCCGG
ATCCCTGACTACTAAAAAA -> TCCCTGACTACTAAAAAAG
TACGCCACCCACAGCTTTT -> ACGCCACCCACAGCTTTTA
ACCGATACAGATACGCCAC -> CCGATACAGATACGCCACC
TGTTAGTAATTAGGTGAAT -> GTTAGTAATTAGGTGAATT
TCATTACTCCTGATGCCGA -> CATTACTCCTGATGCCGAC
TCGTGTGACCGTTACTTGA -> CGTGTGACCGTTACTTGAG
CGTTTGATCACCATCCCCT -> GTTTGATCACCATCCCCTA
AAGATACGCCACCCACAGC -> AGATACGCCACCCACAGCA
CTTCGAACAGGACATGCCC -> TTCGAACAGGACATGCCCA
AGGACCTCAGGGGTCGACG -> GGACCTCAGGGGTCGACGG
TTGAGTGTGACTCCCGTTA -> TGAGTGTGACTCCCGTTAT
ATGTAGGATATTTTACGAT -> TGTAGGATATTTTACGATC
GTTAACGTAAAATGGGCGA -> TTAACGTAAAATGGGCGAA
AGTCTGGAGCTAGGCTTAA -> GTCTGGAGCTAGGCTTAAC
GTGTCCGTGCGGTCGTGAT -> TGTCCGTGCGGTCGTGATT
TCCGGCTGTGGACTCTCGT -> CCGGCTGTGGACTCTCGTG
ACTAAAAAAGCTTGTAGTG -> CTAAAAAAGCTTGTAGTGC
TCGTATGGCATTAAACGCT -> CGTATGGCATTAAACGCTG
ATACGCCACCCACAGCCTG -> TACGCCACCCACAGCCTGT
AGGTAGACGAGGAAGCATA -> GGTAGACGAGGAAGCATAT
CAACACCCACTTGTTACCA -> AACACCCACTTGTTACCAG
TAGCGAAGGATGTCGTACA -> AGCGAAGGATGTCGTACAC
TCGACGTCCCGGTAGCTCT -> CGACGTCCCGGTAGCTCTC
CACAGCGTGCGGTCTGCAT -> ACAGCGTGCGGTCTGCATA
TTCATTGACATAACTAGAC -> TCATTGACATAACTAGACC
AACGTAAAATGGGCGAATG -> ACGTAAAATGGGCGAATGA
TTAGACCGATACAGATACG -> TAGACCGATACAGATACGC
AGTCTCGACGTCCCGGTAG -> GTCTCGACGTCCCGGTAGC
CGAGTGATAAAGTCTGGAG -> GAGTGATAAAGTCTGGAGC
TGACTACTAAAAAAGCTTG -> GACTACTAAAAAAGCTTGT
TGTATACGATCTTTCATTT -> GTATACGATCTTTCATTTC
TACGCCACCCACAGCGTTG -> ACGCCACCCACAGCGTTGA
CTCCCCAGTCTTCATAAGT -> TCCCCAGTCTTCATAAGTA
GGGAAAGGATTGTATTCTG -> GGAAAGGATTGTATTCTGG
CTAGCTAGCGCAAAAAAAT -> TAGCTAGCGCAAAAAAATG
TAATCCGCGTGTCGTGTGA -> AATCCGCGTGTCGTGTGAC
GCTGGTATCTTCATGTTAG -> CTGGTATCTTCATGTTAGT
TAGTCTCGACGTCCCGGTA -> AGTCTCGACGTCCCGGTAG
ACAGTCGGCTGGCAAGCCA -> CAGTCGGCTGGCAAGCCAG
TTCATGTTAGTAATTAGGT -> TCATGTTAGTAATTAGGTG
GGCCGTCAATCGATCCGGA -> GCCGTCAATCGATCCGGAG
GTTGTAAGGCTATCATATC -> TTGTAAGGCTATCATATCG
CTGATGCCGACGCAAATAT -> TGATGCCGACGCAAATATG
CTCAAGCGTCGAACACCAA -> TCAAGCGTCGAACACCAAG
CTAGACCCCGTGTGGATTA -> TAGACCCCGTGTGGATTAG
GGAAAGGATTGTATTCTGG -> GAAAGGATTGTATTCTGGG
ACGTTGGCCGATTCTGGCA -> CGTTGGCCGATTCTGGCAC
TTTTACGATCAAGGGCCGG -> TTTACGATCAAGGGCCGGG
TCGACGGTGCAGGACACAC -> CGACGGTGCAGGACACACC
AAAAACAGGTCTAGATTAA -> AAAACAGGTCTAGATTAAG
TCTAGAGAAGCGCTCGCAA -> CTAGAGAAGCGCTCGCAAC
AGGGAAAGGATTGTATTCT -> GGGAAAGGATTGTATTCTG
ATGCTTACAACTTCATTGA -> TGCTTACAACTTCATTGAC
CATTGACATAACTAGACCC -> ATTGACATAACTAGACCCA
AGGTCTAGATTAAGGGTAC -> GGTCTAGATTAAGGGTACA
CTGCATACACAGCGTGCGG -> TGCATACACAGCGTGCGGT
CTTGTTCCCGTCTAGATTT -> TTGTTCCCGTCTAGATTTC
TCACTTTGAGTCTTAGTAA -> CACTTTGAGTCTTAGTAAG
CGTGAGTCACCGTCGGAAG -> GTGAGTCACCGTCGGAAGG
AAAATGCTTGAATAGATTA -> AAATGCTTGAATAGATTAA
CCGCTTTGATGTGGCCAAT -> CGCTTTGATGTGGCCAATC
CAGCAGTGGGACCGAGCCC -> AGCAGTGGGACCGAGCCCC
GATAAAGTCTGGAGCTAGG -> ATAAAGTCTGGAGCTAGGC
CGTTTGGTATGGCTGGTAT -> GTTTGGTATGGCTGGTATC
TACCCCCATGGTCGCGTGT -> ACCCCCATGGTCGCGTGTC
GAAAATCTTGAGAACACTC -> AAAATCTTGAGAACACTCC
GCCAATATGGCCGATTGTT -> CCAATATGGCCGATTGTTA
TACGATAGGTAGACGAGGA -> ACGATAGGTAGACGAGGAA
TCTTTAGACCCGTTTGATC -> CTTTAGACCCGTTTGATCA
CCGTCAATCGATCCGGAGG -> CGTCAATCGATCCGGAGGG
GCTGCTTTTATCCCCACAC -> CTGCTTTTATCCCCACACA
TTAAAAGCCCCGCTTTGAT -> TAAAAGCCCCGCTTTGATG
TGCGTTGTAAGGCTATCAT -> GCGTTGTAAGGCTATCATA
AGTCCCTGTAGTTGGTTTC -> GTCCCTGTAGTTGGTTTCC
TTACTTGAGTGTGACTCCC -> TACTTGAGTGTGACTCCCG
GTGCTTTACCTTATCATTA -> TGCTTTACCTTATCATTAC
CTGACCCACTACTTTACAC -> TGACCCACTACTTTACACC
TAGTTGGTTTCCACGTACT -> AGTTGGTTTCCACGTACTC
TACCAGTACAGGTACTGTA -> ACCAGTACAGGTACTGTAG
AGTCTTAGTAAGGAAAAAC -> GTCTTAGTAAGGAAAAACA
ATGATTTCCGAAGAACTTA -> TGATTTCCGAAGAACTTAT
CCAGTACAGGTACTGTAGT -> CAGTACAGGTACTGTAGTT
TAGTGGTCTGCATACACAG -> AGTGGTCTGCATACACAGC
GCCATCACTATGACGTTGG -> CCATCACTATGACGTTGGC
GTCTTGCCTACCTTGTTTC -> TCTTGCCTACCTTGTTTCG
CTTCATCGGCAGTGATGAT -> TTCATCGGCAGTGATGATT
CAGTCGGCTGGCAAGCCAG -> AGTCGGCTGGCAAGCCAGC
ACTTGAGTGTGACTCCCGT -> CTTGAGTGTGACTCCCGTT
CCTCAGGGGTCGACGGTGC -> CTCAGGGGTCGACGGTGCA
CCCGCGAGTGATAAAGTCT -> CCGCGAGTGATAAAGTCTG
GGGAATTCGACGCTCCGGC -> GGAATTCGACGCTCCGGCT
TGGGCGAATGACACGCGAG -> GGGCGAATGACACGCGAGT
TTATAACGTCCATCGTGCT -> TATAACGTCCATCGTGCTG
ATCTGTCTTGCCTACCTTG -> TCTGTCTTGCCTACCTTGT
TGTTTCGCCTCAGCTGAGC -> GTTTCGCCTCAGCTGAGCA
CCCTGTACCATTTCTCAAG -> CCTGTACCATTTCTCAAGC
CAAGAGGACAGCGGTCTGC -> AAGAGGACAGCGGTCTGCA
GAACTTATGCTTACAACTT -> AACTTATGCTTACAACTTC
TCGGGCCGGTACATTTTAT -> CGGGCCGGTACATTTTATG
GCGGTCGTGATTTCCCCAT -> CGGTCGTGATTTCCCCATT
ATAGACCAAGATACGCCAC -> TAGACCAAGATACGCCACC
ACGTCCATCGTGCTGATGT -> CGTCCATCGTGCTGATGTT
AAGGAAAAACAGGTCTAGA -> AGGAAAAACAGGTCTAGAT
AGCGCTCGCAACACTTCAG -> GCGCTCGCAACACTTCAGT
CCTCTCGGATCTGTCTTGC -> CTCTCGGATCTGTCTTGCC
AAGAACTTATGCTTACAAC -> AGAACTTATGCTTACAACT
TTACTCCTGATGCCGACGC -> TACTCCTGATGCCGACGCA
AATGTAGGATATTTTACGA -> ATGTAGGATATTTTACGAT
AATCGATCCGGAGGGAAAG -> ATCGATCCGGAGGGAAAGG
GGCTTCGAACAGGACATGC -> GCTTCGAACAGGACATGCC
CAGTCTAAGATCACGACTT -> AGTCTAAGATCACGACTTT
ATAGGCCGACATTGAACTG -> TAGGCCGACATTGAACTGA
CCCCAGTCTTCATAAGTAA -> CCCAGTCTTCATAAGTAAG
CGCCACCCACAGCCTGTTG -> GCCACCCACAGCCTGTTGC
CAACTGGCATACTGCCGCC -> AACTGGCATACTGCCGCCT
AGCCAATATGGCCGATTGT -> GCCAATATGGCCGATTGTT
CACACCTGCGTTGTAAGGC -> ACACCTGCGTTGTAAGGCT
AACTTATGCTTACAACTTC -> ACTTATGCTTACAACTTCA
GATGATTTCCGAAGAACTT -> ATGATTTCCGAAGAACTTA
CTTTGATGTGGCCAATCGG -> TTTGATGTGGCCAATCGGT
CCCACAGCTTTTAGGTAGT -> CCACAGCTTTTAGGTAGTG
GCCGGGATTAGACCGATAC -> CCGGGATTAGACCGATACA
ATACGATCTTTCATTTCGT -> TACGATCTTTCATTTCGTA
GTGATATGTACGGAGGTCG -> TGATATGTACGGAGGTCGG
GCTAGCGCAAAAAAATGCT -> CTAGCGCAAAAAAATGCTT
GCAATGTCAAATTTGCTCG -> CAATGTCAAATTTGCTCGT
TAAGGCTATCATATCGTCT -> AAGGCTATCATATCGTCTA
GTCGACTCCCGTTTGAACC -> TCGACTCCCGTTTGAACCC
TGATGCAGGAACCGTCTAG -> GATGCAGGAACCGTCTAGA
GTGTGACCGTTACTTGAGT -> TGTGACCGTTACTTGAGTG
CGTTATAACGTCCATCGTG -> GTTATAACGTCCATCGTGC
ATAGTATCCGTTTGGTATG -> TAGTATCCGTTTGGTATGG
TAAAAGCCCCGCTTTGATG -> AAAAGCCCCGCTTTGATGT
GCTGGGGTTGGCATGTGAT -> CTGGGGTTGGCATGTGATA
TTTTAGGTAGTGGTCTGCA -> TTTAGGTAGTGGTCTGCAT
GCTTTTAGGTAGTGGTCTG -> CTTTTAGGTAGTGGTCTGC
ACACCAACACACTGGTGTT -> CACCAACACACTGGTGTTC
ACTATGTACGATAGGTAGA -> CTATGTACGATAGGTAGAC
ATAGGTAGACGAGGAAGCA -> TAGGTAGACGAGGAAGCAT
CAGACAATGCTTAGCGAAG -> AGACAATGCTTAGCGAAGG
GCCGACGCAAATATGAGGC -> CCGACGCAAATATGAGGCC
CGCAGGAACCCGGGACACT -> GCAGGAACCCGGGACACTC
CAGGACACACCTGCGTTGT -> AGGACACACCTGCGTTGTA
GAGAAAATCTTGAGAACAC -> AGAAAATCTTGAGAACACT
GAACAATGTAGGATATTTT -> AACAATGTAGGATATTTTA
CTCACATTGTGGCAACTGG -> TCACATTGTGGCAACTGGC
GGTCTAGATTAAGGGTACA -> GTCTAGATTAAGGGTACAT
TCAGCTGAGCAATGCTGGG -> CAGCTGAGCAATGCTGGGG
CATCGTGCTGATGTTGATG -> ATCGTGCTGATGTTGATGC
CCGATACAGATACGCCACC -> CGATACAGATACGCCACCC
AGGCACGTTACTCCTCGGG -> GGCACGTTACTCCTCGGGC
GAGGTCGGTAAAAATAACT -> AGGTCGGTAAAAATAACTA
CTGTTGCGGTGAGATACGC -> TGTTGCGGTGAGATACGCC
GCTTAGCGAAGGATGTCGT -> CTTAGCGAAGGATGTCGTA
ATCTTCATGTTAGTAATTA -> TCTTCATGTTAGTAATTAG
GCAGTGGGACCGAGCCCCA -> CAGTGGGACCGAGCCCCAT
CGCTAGCAACACCCACTTG -> GCTAGCAACACCCACTTGT
AAGCCACGACTGATTAATG -> AGCCACGACTGATTAATGG
CCCTGACTACTAAAAAAGC -> CCTGACTACTAAAAAAGCT
GTACGATAGGTAGACGAGG -> TACGATAGGTAGACGAGGA
GACCGATACAGATACGCCA -> ACCGATACAGATACGCCAC
ATCTATCAGTCTAAGATCA -> TCTATCAGTCTAAGATCAC
TAGACGAGGAAGCATATCA -> AGACGAGGAAGCATATCAT
TTAGACCCGTTTGATCACC -> TAGACCCGTTTGATCACCA
GATCCGGAGGGAAAGGATT -> ATCCGGAGGGAAAGGATTG
GTACATACTCTCATCCTGA -> TACATACTCTCATCCTGAC
AGATACGCCACCCACAGCT -> GATACGCCACCCACAGCTT
GAGACGCTGTGTGGATAAG -> AGACGCTGTGTGGATAAGC
AGTACAGGTACTGTAGTTA -> GTACAGGTACTGTAGTTAT
ACCCACAGCGTTGAATTTG -> CCCACAGCGTTGAATTTGG
CAGGAACCCGGGACACTCA -> AGGAACCCGGGACACTCAC
TTGAGGTACTACCTCGCTT -> TGAGGTACTACCTCGCTTT
CTGCGTTGTAAGGCTATCA -> TGCGTTGTAAGGCTATCAT
AGTACTAGCCCTCCCCAGT -> GTACTAGCCCTCCCCAGTC
CGACGCAAATATGAGGCCC -> GACGCAAATATGAGGCCCG
GCTGGCAAGCCAGCTAATG -> CTGGCAAGCCAGCTAATGA
TAGTGCGCTAGCAACACCC -> AGTGCGCTAGCAACACCCA
TGACTTGTTCCCGTCTAGA -> GACTTGTTCCCGTCTAGAT
TACTTTACACCTTTAGCCA -> ACTTTACACCTTTAGCCAA
CAGCTGAGCAATGCTGGGG -> AGCTGAGCAATGCTGGGGT
CCTTGATATAGTAGGACAG -> CTTGATATAGTAGGACAGT
TGAGGTACTACCTCGCTTT -> GAGGTACTACCTCGCTTTA
TTTCGCCTCAGCTGAGCAA -> TTCGCCTCAGCTGAGCAAT
CAATCGAGTAAATAGTATC -> AATCGAGTAAATAGTATCC
AGTTTGGGCAATGTCAAAT -> GTTTGGGCAATGTCAAATT
ATAGTCGACTCCCGTTTGA -> TAGTCGACTCCCGTTTGAA
TCGTGCGGGGTTATGACTT -> CGTGCGGGGTTATGACTTG
ACCTCGCTTTAGTCTCGAC -> CCTCGCTTTAGTCTCGACG
GTCGCGTGTCAGGCTTTGA -> TCGCGTGTCAGGCTTTGAG
AGATAGGCCGACATTGAAC -> GATAGGCCGACATTGAACT
CTGGGAATTCGACGCTCCG -> TGGGAATTCGACGCTCCGG
TGTACGATAGGTAGACGAG -> GTACGATAGGTAGACGAGG
CCAACCCAGTGACCATCCC -> CAACCCAGTGACCATCCCT
AGCCGGATCTATCAGTCTA -> GCCGGATCTATCAGTCTAA
CCGTCGGAAGGTCATACTC -> CGTCGGAAGGTCATACTCT
GGTGTCCGTGCGGTCGTGA -> GTGTCCGTGCGGTCGTGAT
ACCCAGTGACCATCCCTGA -> CCCAGTGACCATCCCTGAC
TACTCCTGATGCCGACGCA -> ACTCCTGATGCCGACGCAA
ACCTTTAGCCAATATGGCC -> CCTTTAGCCAATATGGCCG
GGGACACTCACATTGTGGC -> GGACACTCACATTGTGGCA
GAAGCATATCATCGGTACC -> AAGCATATCATCGGTACCC
CATTACTCCTGATGCCGAC -> ATTACTCCTGATGCCGACG
GTATGAACCTCTTTAGACC -> TATGAACCTCTTTAGACCC
CTACCTCGCTTTAGTCTCG -> TACCTCGCTTTAGTCTCGA
TAGTAATTAGGTGAATTGG -> AGTAATTAGGTGAATTGGA
CGTGTGGATTAGACATGAT -> GTGTGGATTAGACATGATC
TCACACCAACACACTGGTG -> CACACCAACACACTGGTGT
ACTCACACCAACACACTGG -> CTCACACCAACACACTGGT
AATGACCCTCTCGGATCTG -> ATGACCCTCTCGGATCTGT
CAATATGGCCGATTGTTAA -> AATATGGCCGATTGTTAAC
ATTCAGCTTAGATAGGCCG -> TTCAGCTTAGATAGGCCGA
GTTATAACGTCCATCGTGC -> TTATAACGTCCATCGTGCT
TGCATACACAGCGTGGCCT -> GCATACACAGCGTGGCCTG
TCCCCTAGCTAGCGCAAAA -> CCCCTAGCTAGCGCAAAAA
TACACAGCGTGAGTCACCG -> ACACAGCGTGAGTCACCGT
TTTCCACGTACTCAATTCA -> TTCCACGTACTCAATTCAG
TGGGAGCAAGTATAAAGCG -> GGGAGCAAGTATAAAGCGT
CCCACAGCAAGAGGACAGC -> CCACAGCAAGAGGACAGCG
AAGGGCCGGGATTAGACCG -> AGGGCCGGGATTAGACCGA
GACTTGTTCCCGTCTAGAT -> ACTTGTTCCCGTCTAGATT
ATACGCCACCCACAGCAAG -> TACGCCACCCACAGCAAGA
CGCTCCGGCTGTGGACTCT -> GCTCCGGCTGTGGACTCTC
ACAGCGTGGCCTGTATACG -> CAGCGTGGCCTGTATACGA
GCTCGTGAACAATGTAGGA -> CTCGTGAACAATGTAGGAT
CCCCACACAGTTCTACTGC -> CCCACACAGTTCTACTGCC
CAATGTCAAATTTGCTCGT -> AATGTCAAATTTGCTCGTG
CGTGCTGATGTTGATGCAG -> GTGCTGATGTTGATGCAGG
GAGGCCCGCGAGTGATAAA -> AGGCCCGCGAGTGATAAAG
TTCGAACAGGACATGCCCA -> TCGAACAGGACATGCCCAA
CCATCACTATGACGTTGGC -> CATCACTATGACGTTGGCC
CATGCGAGTCGAACTGCAG -> ATGCGAGTCGAACTGCAGC
GGCTATCATATCGTCTAAA -> GCTATCATATCGTCTAAAC
GGGCAATGTCAAATTTGCT -> GGCAATGTCAAATTTGCTC
GCTAGCAACACCCACTTGT -> CTAGCAACACCCACTTGTT
AATTAGGTGAATTGGAATA -> ATTAGGTGAATTGGAATAG
TGATATAGTAGGACAGTCC -> GATATAGTAGGACAGTCCC
ACTTATGCTTACAACTTCA -> CTTATGCTTACAACTTCAT
TTGTAAGGCTATCATATCG -> TGTAAGGCTATCATATCGT
ATACTCTCATCCTGACCCC -> TACTCTCATCCTGACCCCT
GTTATGACTTGTTCCCGTC -> TTATGACTTGTTCCCGTCT
GTAAAAATAACTATGTACG -> TAAAAATAACTATGTACGA
CTAGGCTTAACTCACACCA -> TAGGCTTAACTCACACCAA
TGCGAGTCGAACTGCAGCC -> GCGAGTCGAACTGCAGCCC
CTTTGAGTCTTAGTAAGGA -> TTTGAGTCTTAGTAAGGAA
TTCCGAAGAACTTATGCTT -> TCCGAAGAACTTATGCTTA
ATGCCGACGCAAATATGAG -> TGCCGACGCAAATATGAGG
TGAGGCACGTTACTCCTCG -> GAGGCACGTTACTCCTCGG
TAGCCATCACTATGACGTT -> AGCCATCACTATGACGTTG
TTTACGATCAAGGGCCGGG -> TTACGATCAAGGGCCGGGA
AGTGTGACTCCCGTTATAA -> GTGTGACTCCCGTTATAAC
ACACAGTTCTACTGCCCGA -> CACAGTTCTACTGCCCGAG
CCGATTGTTAACGTAAAAT -> CGATTGTTAACGTAAAATG
ATAGATTAAATCCTCGGGC -> TAGATTAAATCCTCGGGCC
CGCCTCAGCTGAGCAATGC -> GCCTCAGCTGAGCAATGCT
GAACCCGTGTCTGCTGCTT -> AACCCGTGTCTGCTGCTTT
TACGATCTTTCATTTCGTA -> ACGATCTTTCATTTCGTAT
GCGACCGTACGATCGCTCA -> CGACCGTACGATCGCTCAG
TGAGCAATGCTGGGGTTGG -> GAGCAATGCTGGGGTTGGC
CGTGCGGGGTTATGACTTG -> GTGCGGGGTTATGACTTGT
TTAGATAGGCCGACATTGA -> TAGATAGGCCGACATTGAA
GTGCCCAATCCCAATCGAG -> TGCCCAATCCCAATCGAGT
AGGCTTAACTCACACCAAC -> GGCTTAACTCACACCAACA
TAGATTAAATCCTCGGGCC -> AGATTAAATCCTCGGGCCG
AATTTGGGGTCTGCATACA -> ATTTGGGGTCTGCATACAC
AGTCTAAGATCACGACTTT -> GTCTAAGATCACGACTTTT
TTCAGTGCTTTACCTTATC -> TCAGTGCTTTACCTTATCA
CCAATCGAGTAAATAGTAT -> CAATCGAGTAAATAGTATC
CTGCCCGAGAGAAAATCTT -> TGCCCGAGAGAAAATCTTG
CCACTACTTTACACCTTTA -> CACTACTTTACACCTTTAG
TGGTTATCGTGCCTTCGAG -> GGTTATCGTGCCTTCGAGG
CCAATCGGTGCCCAATCCC -> CAATCGGTGCCCAATCCCA
AACAGTCGGCTGGCAAGCC -> ACAGTCGGCTGGCAAGCCA
CGGCTGTGGACTCTCGTGC -> GGCTGTGGACTCTCGTGCG
ATCTTTCATTTCGTATGGC -> TCTTTCATTTCGTATGGCA
ACACCTTTAGCCAATATGG -> CACCTTTAGCCAATATGGC
AGGGGTCGACGGTGCAGGA -> GGGGTCGACGGTGCAGGAC
CCAACACACTGGTGTTCAC -> CAACACACTGGTGTTCACT
AAATTAATCCGCGTGTCGT -> AATTAATCCGCGTGTCGTG
GGGACCGAGCCCCATGAGG -> GGACCGAGCCCCATGAGGA
TAGACCAAGATACGCCACC -> AGACCAAGATACGCCACCC
AGTGATAAAGTCTGGAGCT -> GTGATAAAGTCTGGAGCTA
TGCAGGACACACCTGCGTT -> GCAGGACACACCTGCGTTG
TAATAGTCGACTCCCGTTT -> AATAGTCGACTCCCGTTTG
CGCCACCCACAGCGTTGAA -> GCCACCCACAGCGTTGAAT
GTTTCCACGTACTCAATTC -> TTTCCACGTACTCAATTCA
ACCCACAGCTTTTAGGTAG -> CCCACAGCTTTTAGGTAGT
CGGATCTGTCTTGCCTACC -> GGATCTGTCTTGCCTACCT
CGACGCTCCGGCTGTGGAC -> GACGCTCCGGCTGTGGACT
CAAGCCAGCTAATGACCCT -> AAGCCAGCTAATGACCCTC
TGCGGGCTGACCCACTACT -> GCGGGCTGACCCACTACTT
TAGTAAGGAAAAACAGGTC -> AGTAAGGAAAAACAGGTCT
TGGTATCTTCATGTTAGTA -> GGTATCTTCATGTTAGTAA
ACCCACAGCCTGTTGCGGT -> CCCACAGCCTGTTGCGGTG
TAAGCCGGATCTATCAGTC -> AAGCCGGATCTATCAGTCT
CCGTTATAACGTCCATCGT -> CGTTATAACGTCCATCGTG
CTAGCCCTCCCCAGTCTTC -> TAGCCCTCCCCAGTCTTCA
GTGTGGATAAGCCGGATCT -> TGTGGATAAGCCGGATCTA
TAAGTAAGCCACGACTGAT -> AAGTAAGCCACGACTGATT
AGGAAAAACAGGTCTAGAT -> GGAAAAACAGGTCTAGATT
CGTCTAAACAGGCGACCGT -> GTCTAAACAGGCGACCGTA
TATGACTTGTTCCCGTCTA -> ATGACTTGTTCCCGTCTAG
ACGACTGATTAATGGTGAG -> CGACTGATTAATGGTGAGG
GACCCCTGTACCATTTCTC -> ACCCCTGTACCATTTCTCA
TCCCGTCTAGATTTCCCCA -> CCCGTCTAGATTTCCCCAG
GCCGTCAATCGATCCGGAG -> CCGTCAATCGATCCGGAGG
CAATCCCAATCGAGTAAAT -> AATCCCAATCGAGTAAATA
GGCAACTGGCATACTGCCG -> GCAACTGGCATACTGCCGC
AATATGAGGCCCGCGAGTG -> ATATGAGGCCCGCGAGTGA
GTAGCTCTCCGCCTGCAGA -> TAGCTCTCCGCCTGCAGAA
TACATTTTATGATTGGGAG -> ACATTTTATGATTGGGAGC
TGCTTGAATAGATTAAATC -> GCTTGAATAGATTAAATCC
TGAGTCTTAGTAAGGAAAA -> GAGTCTTAGTAAGGAAAAA
TGACCATCCCTGACTACTA -> GACCATCCCTGACTACTAA
GTAAGGAAAAACAGGTCTA -> TAAGGAAAAACAGGTCTAG
ACCCGTGTCTGCTGCTTTT -> CCCGTGTCTGCTGCTTTTA
ACGATCGCTCAGTTTGGGC -> CGATCGCTCAGTTTGGGCA
GGTACATACTCTCATCCTG -> GTACATACTCTCATCCTGA
CCCACAGCCTGTTGCGGTG -> CCACAGCCTGTTGCGGTGA
GGACAGCGGTCTGCATACA -> GACAGCGGTCTGCATACAC
CGAGAGAAAATCTTGAGAA -> GAGAGAAAATCTTGAGAAC
AACCCGGGACACTCACATT -> ACCCGGGACACTCACATTG
CCGTACGATCGCTCAGTTT -> CGTACGATCGCTCAGTTTG
GTAATTAGGTGAATTGGAA -> TAATTAGGTGAATTGGAAT
CGGTAAAAATAACTATGTA -> GGTAAAAATAACTATGTAC
GGGCCGGGATTAGACCGAT -> GGCCGGGATTAGACCGATA
GCTCGCAACACTTCAGTGC -> CTCGCAACACTTCAGTGCT
TCGTGATTTCCCCATTCTG -> CGTGATTTCCCCATTCTGG
ATGTCAAATTTGCTCGTGA -> TGTCAAATTTGCTCGTGAA
ACGCTCCGGCTGTGGACTC -> CGCTCCGGCTGTGGACTCT
TGTGGATAAGCCGGATCTA -> GTGGATAAGCCGGATCTAT
AGCGTCGAACACCAAGAGT -> GCGTCGAACACCAAGAGTA
ATAACTAGACCCAGACAAT -> TAACTAGACCCAGACAATG
TTGGGGTCTGCATACACAG -> TGGGGTCTGCATACACAGC
GTGATTTCCCCATTCTGGT -> TGATTTCCCCATTCTGGTG
CTCCTGATGCCGACGCAAA -> TCCTGATGCCGACGCAAAT
CTTAGTAAGGAAAAACAGG -> TTAGTAAGGAAAAACAGGT
AGCAATGCTGGGGTTGGCA -> GCAATGCTGGGGTTGGCAT
ACCATCCCTGACTACTAAA -> CCATCCCTGACTACTAAAA
CCCCGCTTTGATGTGGCCA -> CCCGCTTTGATGTGGCCAA
GCAGCCCCCGTTCGTCGAC -> CAGCCCCCGTTCGTCGACT
CTGCATACACAGCGTGAGT -> TGCATACACAGCGTGAGTC
GGGGTTATGACTTGTTCCC -> GGGTTATGACTTGTTCCCG
TGCAGAACACAGCAGTGGG -> GCAGAACACAGCAGTGGGA
CTACTTTACACCTTTAGCC -> TACTTTACACCTTTAGCCA
CGGTGCAGGACACACCTGC -> GGTGCAGGACACACCTGCG
TGTACGGAGGTCGGTAAAA -> GTACGGAGGTCGGTAAAAA
GGACAGTCCCAAAATTAAA -> GACAGTCCCAAAATTAAAA
CGTGTCTGCTGCTTTTATC -> GTGTCTGCTGCTTTTATCC
TCGCCTCAGCTGAGCAATG -> CGCCTCAGCTGAGCAATGC
CTCATCCTGACCCCTGTAC -> TCATCCTGACCCCTGTACC
TATGAACCTCTTTAGACCC -> ATGAACCTCTTTAGACCCG
TTTGGGCAATGTCAAATTT -> TTGGGCAATGTCAAATTTG
GATTCTGGCACCCTTGATA -> ATTCTGGCACCCTTGATAT
TCGTCTAAACAGGCGACCG -> CGTCTAAACAGGCGACCGT
ACATTGAACTGAGACGCTG -> CATTGAACTGAGACGCTGT
GGTGAATTGGAATAGATAC -> GTGAATTGGAATAGATACG
TGACCCCTGTACCATTTCT -> GACCCCTGTACCATTTCTC
ACCTCTTTAGACCCGTTTG -> CCTCTTTAGACCCGTTTGA
AAATCCTCGGGCCGTCAAT -> AATCCTCGGGCCGTCAATC
GGCTGACCCACTACTTTAC -> GCTGACCCACTACTTTACA
GTATCTTCATGTTAGTAAT -> TATCTTCATGTTAGTAATT
GGATTAGACATGATCTTCA -> GATTAGACATGATCTTCAA
CCGAGAGAAAATCTTGAGA -> CGAGAGAAAATCTTGAGAA
GATTTCCCCATTCTGGTGA -> ATTTCCCCATTCTGGTGAT
TATTCTGGGAATTCGACGC -> ATTCTGGGAATTCGACGCT
CATTTCTCAAGCGTCGAAC -> ATTTCTCAAGCGTCGAACA
CGTGCGGTCTGCATACACA -> GTGCGGTCTGCATACACAG
TATGCCCGTGCGGGCTGAC -> ATGCCCGTGCGGGCTGACC
TCACGACTTTTTGAGGTAC -> CACGACTTTTTGAGGTACT
AACGTCCATCGTGCTGATG -> ACGTCCATCGTGCTGATGT
ACATTGTGGCAACTGGCAT -> CATTGTGGCAACTGGCATA
CCTACCTTGTTTCGCCTCA -> CTACCTTGTTTCGCCTCAG
GGTCGCGTGTCAGGCTTTG -> GTCGCGTGTCAGGCTTTGA
GTGTGACTCCCGTTATAAC -> TGTGACTCCCGTTATAACG
CTATCAGTCTAAGATCACG -> TATCAGTCTAAGATCACGA
TTCATAAGTAAGCCACGAC -> TCATAAGTAAGCCACGACT
ATGTCGTACACATGATTTC -> TGTCGTACACATGATTTCG
CATGGTCGCGTGTCAGGCT -> ATGGTCGCGTGTCAGGCTT
ACTTGTTACCAGTACAGGT -> CTTGTTACCAGTACAGGTA
TCCCTGCAGAACACAGCAG -> CCCTGCAGAACACAGCAGT
GTCTCATGGTTATCGTGCC -> TCTCATGGTTATCGTGCCT
ACGCTGAACAGTCGGCTGG -> CGCTGAACAGTCGGCTGGC
AAGGATTGTATTCTGGGAA -> AGGATTGTATTCTGGGAAT
CGTTGAATTTGGGGTCTGC -> GTTGAATTTGGGGTCTGCA
CGTGCCAACCCAGTGACCA -> GTGCCAACCCAGTGACCAT
TCATAAGTAAGCCACGACT -> CATAAGTAAGCCACGACTG
ATACGCCACCCACAGCTTT -> TACGCCACCCACAGCTTTT
GCCCAAATTAATCCGCGTG -> CCCAAATTAATCCGCGTGT
GTAGTGCGCTAGCAACACC -> TAGTGCGCTAGCAACACCC
CTAGATTAAGGGTACATAC -> TAGATTAAGGGTACATACT
CAGGACATGCCCAAATTAA -> AGGACATGCCCAAATTAAT
CGCAACACTTCAGTGCTTT -> GCAACACTTCAGTGCTTTA
CAAAGCATGCGCTCTCGTA -> AAAGCATGCGCTCTCGTAC
GCGTGTCGTGTGACCGTTA -> CGTGTCGTGTGACCGTTAC
TTAGTCTCGACGTCCCGGT -> TAGTCTCGACGTCCCGGTA
CCGGTAGCTCTCCGCCTGC -> CGGTAGCTCTCCGCCTGCA
GTCCCTGTAGTTGGTTTCC -> TCCCTGTAGTTGGTTTCCA
GACCCGTTTGATCACCATC -> ACCCGTTTGATCACCATCC
TAAATCCTCGGGCCGTCAA -> AAATCCTCGGGCCGTCAAT
TCTTTCATTTCGTATGGCA -> CTTTCATTTCGTATGGCAT
CCAATATGGCCGATTGTTA -> CAATATGGCCGATTGTTAA
AAATAACTATGTACGATAG -> AATAACTATGTACGATAGG
AGCTAGGCTTAACTCACAC -> GCTAGGCTTAACTCACACC
TACGGAGGTCGGTAAAAAT -> ACGGAGGTCGGTAAAAATA
ACACAGCAGTGGGACCGAG -> CACAGCAGTGGGACCGAGC
GCTTTAGTCTCGACGTCCC -> CTTTAGTCTCGACGTCCCG
TTGAATTTGGGGTCTGCAT -> TGAATTTGGGGTCTGCATA
GGGTACATACTCTCATCCT -> GGTACATACTCTCATCCTG
ACAGGCGACCGTACGATCG -> CAGGCGACCGTACGATCGC
ACCCACAGCAAGAGGACAG -> CCCACAGCAAGAGGACAGC
ACAGCGTTGAATTTGGGGT -> CAGCGTTGAATTTGGGGTC
TGGGAATTCGACGCTCCGG -> GGGAATTCGACGCTCCGGC
AAGTATAAAGCGTCTCATG -> AGTATAAAGCGTCTCATGG
AGACAATGCTTAGCGAAGG -> GACAATGCTTAGCGAAGGA
CCCCGTGTGGATTAGACAT -> CCCGTGTGGATTAGACATG
AACTGCAGCCCCCGTTCGT -> ACTGCAGCCCCCGTTCGTC
CGCGCAGACATACGCAGGA -> GCGCAGACATACGCAGGAA
CCACAGCCTGTTGCGGTGA -> CACAGCCTGTTGCGGTGAG
TCCCAAAATTAAAAGCCCC -> CCCAAAATTAAAAGCCCCG
ATAGATACGCCACCCACAG -> TAGATACGCCACCCACAGC
GCAACACTTCAGTGCTTTA -> CAACACTTCAGTGCTTTAC
CAATGCTTAGCGAAGGATG -> AATGCTTAGCGAAGGATGT
CAGAACACAGCAGTGGGAC -> AGAACACAGCAGTGGGACC
GTTTGATCACCATCCCCTA -> TTTGATCACCATCCCCTAG
ACTGGCATACTGCCGCCTC -> CTGGCATACTGCCGCCTCC
TGTGACCGTTACTTGAGTG -> GTGACCGTTACTTGAGTGT
CCTGCAGAATCTTAATAGT -> CTGCAGAATCTTAATAGTC
GGCACGTTACTCCTCGGGC -> GCACGTTACTCCTCGGGCC
GTTACTCCTCGGGCCGGTA -> TTACTCCTCGGGCCGGTAC
CGTGTCGTGTGACCGTTAC -> GTGTCGTGTGACCGTTACT
TCTGTCTTGCCTACCTTGT -> CTGTCTTGCCTACCTTGTT
GTCGAACTGCAGCCCCCGT -> TCGAACTGCAGCCCCCGTT
ACAGGACATGCCCAAATTA -> CAGGACATGCCCAAATTAA
ATGAGGCCCGCGAGTGATA -> TGAGGCCCGCGAGTGATAA
TGGCCTGTATACGATCTTT -> GGCCTGTATACGATCTTTC
GCGTTGAATTTGGGGTCTG -> CGTTGAATTTGGGGTCTGC
ACAACTTCATTGACATAAC -> CAACTTCATTGACATAACT
TGCTTTTATCCCCACACAG -> GCTTTTATCCCCACACAGT
CGTGCGGTCGTGATTTCCC -> GTGCGGTCGTGATTTCCCC
ATGCCCGTGCGGGCTGACC -> TGCCCGTGCGGGCTGACCC
AGTGATGATTTCCGAAGAA -> GTGATGATTTCCGAAGAAC
GGCTGGCAAGCCAGCTAAT -> GCTGGCAAGCCAGCTAATG
CACTACTTTACACCTTTAG -> ACTACTTTACACCTTTAGC
GTTTGGTATGGCTGGTATC -> TTTGGTATGGCTGGTATCT
TATCTTCATGTTAGTAATT -> ATCTTCATGTTAGTAATTA
GCCTACCTTGTTTCGCCTC -> CCTACCTTGTTTCGCCTCA
AGTTATATGCCCGTGCGGG -> GTTATATGCCCGTGCGGGC
TTCTACTGCCCGAGAGAAA -> TCTACTGCCCGAGAGAAAA
GGATTAGACCGATACAGAT -> GATTAGACCGATACAGATA
CCGCGAGTGATAAAGTCTG -> CGCGAGTGATAAAGTCTGG
TCTTGAGAACACTCCCTGC -> CTTGAGAACACTCCCTGCA
TGACGTTGGCCGATTCTGG -> GACGTTGGCCGATTCTGGC
TGAACCCGTGTCTGCTGCT -> GAACCCGTGTCTGCTGCTT
TCTTTGTAGCCATCACTAT -> CTTTGTAGCCATCACTATG
AACCCAGTGACCATCCCTG -> ACCCAGTGACCATCCCTGA
CAGCGGTCTGCATACACAG -> AGCGGTCTGCATACACAGC
GAGCCCCATGAGGAATAGA -> AGCCCCATGAGGAATAGAC
GATGTGGCCAATCGGTGCC -> ATGTGGCCAATCGGTGCCC
ATTACTCCTGATGCCGACG -> TTACTCCTGATGCCGACGC
CAACTCCCCAAAGCATGCG -> AACTCCCCAAAGCATGCGC
ACAATGTAGGATATTTTAC -> CAATGTAGGATATTTTACG
AAGGCTATCATATCGTCTA -> AGGCTATCATATCGTCTAA
GCAGAACACAGCAGTGGGA -> CAGAACACAGCAGTGGGAC
TCTAAACAGGCGACCGTAC -> CTAAACAGGCGACCGTACG
AATTAAAAGCCCCGCTTTG -> ATTAAAAGCCCCGCTTTGA
GTTCCCGTCTAGATTTCCC -> TTCCCGTCTAGATTTCCCC
TGCCCGAGAGAAAATCTTG -> GCCCGAGAGAAAATCTTGA
GGTACCCCCATGGTCGCGT -> GTACCCCCATGGTCGCGTG
TGTAGTGCGCTAGCAACAC -> GTAGTGCGCTAGCAACACC
TGTAAGGCTATCATATCGT -> GTAAGGCTATCATATCGTC
ATCCTCGGGCCGTCAATCG -> TCCTCGGGCCGTCAATCGA
CGTGATTTCCCCATTCTGG -> GTGATTTCCCCATTCTGGT
TATAGTAGGACAGTCCCAA -> ATAGTAGGACAGTCCCAAA
CAGGGGTCGACGGTGCAGG -> AGGGGTCGACGGTGCAGGA
CTTGCCTACCTTGTTTCGC -> TTGCCTACCTTGTTTCGCC
ACCATCCCCTAGCTAGCGC -> CCATCCCCTAGCTAGCGCA
CGAACACCAAGAGTACATG -> GAACACCAAGAGTACATGC
CTTAGCGAAGGATGTCGTA -> TTAGCGAAGGATGTCGTAC
CATGCCCAAATTAATCCGC -> ATGCCCAAATTAATCCGCG
CTCGGGCCGGTACATTTTA -> TCGGGCCGGTACATTTTAT
GACTCTCGTGCGGGGTTAT -> ACTCTCGTGCGGGGTTATG
AGGACAGCGGTCTGCATAC -> GGACAGCGGTCTGCATACA
CAGCGTGGCCTGTATACGA -> AGCGTGGCCTGTATACGAT
CTGGCATACTGCCGCCTCC -> TGGCATACTGCCGCCTCCA
AGGCTTTGAGTATGAACCT -> GGCTTTGAGTATGAACCTC
ATACACAGCGTGCCAACCC -> TACACAGCGTGCCAACCCA
CTCCTCGGGCCGGTACATT -> TCCTCGGGCCGGTACATTT
CCAAATTAATCCGCGTGTC -> CAAATTAATCCGCGTGTCG
TACAACTTCATTGACATAA -> ACAACTTCATTGACATAAC
GACCGTACGATCGCTCAGT -> ACCGTACGATCGCTCAGTT
TTCCCGTCTAGATTTCCCC -> TCCCGTCTAGATTTCCCCA
CCCGTGTCTGCTGCTTTTA -> CCGTGTCTGCTGCTTTTAT
CATTCTGGTGATAGTCCCT -> ATTCTGGTGATAGTCCCTG
AGTCTTCATAAGTAAGCCA -> GTCTTCATAAGTAAGCCAC
CATGTTAGTAATTAGGTGA -> ATGTTAGTAATTAGGTGAA
TATGTACGGAGGTCGGTAA -> ATGTACGGAGGTCGGTAAA
CCATGGTCGCGTGTCAGGC -> CATGGTCGCGTGTCAGGCT
CCCCATGAGGAATAGACCA -> CCCATGAGGAATAGACCAA
TTGAGTCTTAGTAAGGAAA -> TGAGTCTTAGTAAGGAAAA
ACAGCGTGCCAACCCAGTG -> CAGCGTGCCAACCCAGTGA
CACGTTACTCCTCGGGCCG -> ACGTTACTCCTCGGGCCGG
AGTAAATAGTATCCGTTTG -> GTAAATAGTATCCGTTTGG
GACGGTGCAGGACACACCT -> ACGGTGCAGGACACACCTG
AACACCCACTTGTTACCAG -> ACACCCACTTGTTACCAGT
ATTGTATTCTGGGAATTCG -> TTGTATTCTGGGAATTCGA
CCCTTGATATAGTAGGACA -> CCTTGATATAGTAGGACAG
CCCCATTCTGGTGATAGTC -> CCCATTCTGGTGATAGTCC
ATGTTGATGCAGGAACCGT -> TGTTGATGCAGGAACCGTC
AGGTCGGTAAAAATAACTA -> GGTCGGTAAAAATAACTAT
CCTGTAGTTGGTTTCCACG -> CTGTAGTTGGTTTCCACGT
TTTCCCCATTCTGGTGATA -> TTCCCCATTCTGGTGATAG
ATCACTATGACGTTGGCCG -> TCACTATGACGTTGGCCGA
TAAGGAAAAACAGGTCTAG -> AAGGAAAAACAGGTCTAGA
ATGCTTAGCGAAGGATGTC -> TGCTTAGCGAAGGATGTCG
GCAGTGATGATTTCCGAAG -> CAGTGATGATTTCCGAAGA
TTTGCTCGTGAACAATGTA -> TTGCTCGTGAACAATGTAG
GATCACGACTTTTTGAGGT -> ATCACGACTTTTTGAGGTA
GCGTCGAACACCAAGAGTA -> CGTCGAACACCAAGAGTAC
TTAAATCCTCGGGCCGTCA -> TAAATCCTCGGGCCGTCAA
TCCCCAAAGCATGCGCTCT -> CCCCAAAGCATGCGCTCTC
TTAAGGGTACATACTCTCA -> TAAGGGTACATACTCTCAT
GCTTTTATCCCCACACAGT -> CTTTTATCCCCACACAGTT
TTTTTGAGGTACTACCTCG -> TTTTGAGGTACTACCTCGC
TGTAGTTATATGCCCGTGC -> GTAGTTATATGCCCGTGCG
GTTAGTAATTAGGTGAATT -> TTAGTAATTAGGTGAATTG
CCACAGCAAGAGGACAGCG -> CACAGCAAGAGGACAGCGG
AACACTCCCTGCAGAACAC -> ACACTCCCTGCAGAACACA
CCGTTACTTGAGTGTGACT -> CGTTACTTGAGTGTGACTC
GGAACCGTCTAGACCCCGT -> GAACCGTCTAGACCCCGTG
ATTTGGGGTCTGCATACAC -> TTTGGGGTCTGCATACACA
CGGGATTAGACCGATACAG -> GGGATTAGACCGATACAGA
ATCACCATCCCCTAGCTAG -> TCACCATCCCCTAGCTAGC
GGCCGATTCTGGCACCCTT -> GCCGATTCTGGCACCCTTG
CACCCACTTGTTACCAGTA -> ACCCACTTGTTACCAGTAC
GCAGGAACCCGGGACACTC -> CAGGAACCCGGGACACTCA
CGCCACCCACAGCAAGAGG -> GCCACCCACAGCAAGAGGA
GCTGTGTGGATAAGCCGGA -> CTGTGTGGATAAGCCGGAT
TAATGGTGAGGCACGTTAC -> AATGGTGAGGCACGTTACT
CTAGCGCAAAAAAATGCTT -> TAGCGCAAAAAAATGCTTG
GTGAGGCACGTTACTCCTC -> TGAGGCACGTTACTCCTCG
GCTTCGAACAGGACATGCC -> CTTCGAACAGGACATGCCC
ACAGCGTGCGGTCTGCATA -> CAGCGTGCGGTCTGCATAC
CTTTTATCCCCACACAGTT -> TTTTATCCCCACACAGTTC
TGCAGAATCTTAATAGTCG -> GCAGAATCTTAATAGTCGA
CCCACAGCGTTGAATTTGG -> CCACAGCGTTGAATTTGGG
TGACCCACTACTTTACACC -> GACCCACTACTTTACACCT
CGTCTCATGGTTATCGTGC -> GTCTCATGGTTATCGTGCC
AGCGCAAAAAAATGCTTGA -> GCGCAAAAAAATGCTTGAA
GCATTAAACGCTGAACAGT -> CATTAAACGCTGAACAGTC
GTCTCGACGTCCCGGTAGC -> TCTCGACGTCCCGGTAGCT
AGATTAAGGGTACATACTC -> GATTAAGGGTACATACTCT
CTTTAGTCTCGACGTCCCG -> TTTAGTCTCGACGTCCCGG
CAGCGTGAGTCACCGTCGG -> AGCGTGAGTCACCGTCGGA
CACCATCCCCTAGCTAGCG -> ACCATCCCCTAGCTAGCGC
AGAAAATCTTGAGAACACT -> GAAAATCTTGAGAACACTC
TATATGCCCGTGCGGGCTG -> ATATGCCCGTGCGGGCTGA
GGGCTGACCCACTACTTTA -> GGCTGACCCACTACTTTAC
AGCTGAGCAATGCTGGGGT -> GCTGAGCAATGCTGGGGTT
TGAACTGAGACGCTGTGTG -> GAACTGAGACGCTGTGTGG
ATATTTTACGATCAAGGGC -> TATTTTACGATCAAGGGCC
ACGCCACCCACAGCGTTGA -> CGCCACCCACAGCGTTGAA
AGCCACGACTGATTAATGG -> GCCACGACTGATTAATGGT
TCCGTTTGGTATGGCTGGT -> CCGTTTGGTATGGCTGGTA
CCTCCATGGCTTCGAACAG -> CTCCATGGCTTCGAACAGG
TTTGATGTGGCCAATCGGT -> TTGATGTGGCCAATCGGTG
CTTGTTTCGCCTCAGCTGA -> TTGTTTCGCCTCAGCTGAG
TATCATCGGTACCCCCATG -> ATCATCGGTACCCCCATGG
AGTGCTTTACCTTATCATT -> GTGCTTTACCTTATCATTA
GCAGAATCTTAATAGTCGA -> CAGAATCTTAATAGTCGAC
ACTCTAGAGAAGCGCTCGC -> CTCTAGAGAAGCGCTCGCA
CTTCATTGACATAACTAGA -> TTCATTGACATAACTAGAC
GAATAGATTAAATCCTCGG -> AATAGATTAAATCCTCGGG
AACAATGTAGGATATTTTA -> ACAATGTAGGATATTTTAC
GCGTCTCATGGTTATCGTG -> CGTCTCATGGTTATCGTGC
TTTGAACCCGTGTCTGCTG -> TTGAACCCGTGTCTGCTGC
GGTTTCCACGTACTCAATT -> GTTTCCACGTACTCAATTC
AATGCTTAGCGAAGGATGT -> ATGCTTAGCGAAGGATGTC
ATTGGAATAGATACGCCAC -> TTGGAATAGATACGCCACC
GACATGCCCAAATTAATCC -> ACATGCCCAAATTAATCCG
ACTCTTTGTAGCCATCACT -> CTCTTTGTAGCCATCACTA
CTAGCAACACCCACTTGTT -> TAGCAACACCCACTTGTTA
ATACTGCCGCCTCCATGGC -> TACTGCCGCCTCCATGGCT
CATCGGCAGTGATGATTTC -> ATCGGCAGTGATGATTTCC
CAGCGTGCCAACCCAGTGA -> AGCGTGCCAACCCAGTGAC
TTGGTTTCCACGTACTCAA -> TGGTTTCCACGTACTCAAT
GATTAGACCGATACAGATA -> ATTAGACCGATACAGATAC
GTCGGCTGGCAAGCCAGCT -> TCGGCTGGCAAGCCAGCTA
TCTCGACGTCCCGGTAGCT -> CTCGACGTCCCGGTAGCTC
GGCAATGTCAAATTTGCTC -> GCAATGTCAAATTTGCTCG
TACTACCTCGCTTTAGTCT -> ACTACCTCGCTTTAGTCTC
CAATTCAGCTTAGATAGGC -> AATTCAGCTTAGATAGGCC
TTTCTCAAGCGTCGAACAC -> TTCTCAAGCGTCGAACACC
GTCCCAAAATTAAAAGCCC -> TCCCAAAATTAAAAGCCCC
CACATGATTTCGCGCAGAC -> ACATGATTTCGCGCAGACA
TATCCCCACACAGTTCTAC -> ATCCCCACACAGTTCTACT
AACTCTTTGTAGCCATCAC -> ACTCTTTGTAGCCATCACT
CCGAAGAACTTATGCTTAC -> CGAAGAACTTATGCTTACA
CCGGTACATTTTATGATTG -> CGGTACATTTTATGATTGG
ACCGAGCCCCATGAGGAAT -> CCGAGCCCCATGAGGAATA
ACCTTGTTTCGCCTCAGCT -> CCTTGTTTCGCCTCAGCTG
AGCAAGTATAAAGCGTCTC -> GCAAGTATAAAGCGTCTCA
TGGCATTAAACGCTGAACA -> GGCATTAAACGCTGAACAG
AGTCGAACTGCAGCCCCCG -> GTCGAACTGCAGCCCCCGT
CCGGCTGTGGACTCTCGTG -> CGGCTGTGGACTCTCGTGC
TCATTGACATAACTAGACC -> CATTGACATAACTAGACCC
CGCTCAGTTTGGGCAATGT -> GCTCAGTTTGGGCAATGTC
AACTGAGACGCTGTGTGGA -> ACTGAGACGCTGTGTGGAT
CTGAACAGTCGGCTGGCAA -> TGAACAGTCGGCTGGCAAG
CATATCGTCTAAACAGGCG -> ATATCGTCTAAACAGGCGA
TGGTCGCGTGTCAGGCTTT -> GGTCGCGTGTCAGGCTTTG
GTCTAGATTAAGGGTACAT -> TCTAGATTAAGGGTACATA
GGCCTGTATACGATCTTTC -> GCCTGTATACGATCTTTCA
AAATGCTTGAATAGATTAA -> AATGCTTGAATAGATTAAA
GCTTGTAGTGCGCTAGCAA -> CTTGTAGTGCGCTAGCAAC
TCGGTACCCCCATGGTCGC -> CGGTACCCCCATGGTCGCG
CGTTTGAACCCGTGTCTGC -> GTTTGAACCCGTGTCTGCT
CATTGAACTGAGACGCTGT -> ATTGAACTGAGACGCTGTG
GCACCCTTGATATAGTAGG -> CACCCTTGATATAGTAGGA
GATCTATCAGTCTAAGATC -> ATCTATCAGTCTAAGATCA
CGTATGGCATTAAACGCTG -> GTATGGCATTAAACGCTGA
GATCACCATCCCCTAGCTA -> ATCACCATCCCCTAGCTAG
TGGCCAATCGGTGCCCAAT -> GGCCAATCGGTGCCCAATC
GTCTAAGATCACGACTTTT -> TCTAAGATCACGACTTTTT
CTTGAGTGTGACTCCCGTT -> TTGAGTGTGACTCCCGTTA
CACACCAACACACTGGTGT -> ACACCAACACACTGGTGTT
AAAAAAGCTTGTAGTGCGC -> AAAAAGCTTGTAGTGCGCT
GCGTGTCAGGCTTTGAGTA -> CGTGTCAGGCTTTGAGTAT
CACCTGCGTTGTAAGGCTA -> ACCTGCGTTGTAAGGCTAT
CCCACTTGTTACCAGTACA -> CCACTTGTTACCAGTACAG
CGTACTCAATTCAGCTTAG -> GTACTCAATTCAGCTTAGA
TGGCTGGTATCTTCATGTT -> GGCTGGTATCTTCATGTTA
CAGTCCCAAAATTAAAAGC -> AGTCCCAAAATTAAAAGCC
AGGACACACCTGCGTTGTA -> GGACACACCTGCGTTGTAA
ATGCTTGAATAGATTAAAT -> TGCTTGAATAGATTAAATC
TAGACCCGTTTGATCACCA -> AGACCCGTTTGATCACCAT
ACCCCGTGTGGATTAGACA -> CCCCGTGTGGATTAGACAT
TTCGTCGACTCTTGCCTTC -> TCGTCGACTCTTGCCTTCA
GCATACACAGCGTGGCCTG -> CATACACAGCGTGGCCTGT
GTCGACGGTGCAGGACACA -> TCGACGGTGCAGGACACAC
TTGATATAGTAGGACAGTC -> TGATATAGTAGGACAGTCC
GGAGGGAAAGGATTGTATT -> GAGGGAAAGGATTGTATTC
TTTCGCGCAGACATACGCA -> TTCGCGCAGACATACGCAG
GATGTCGTACACATGATTT -> ATGTCGTACACATGATTTC
GGTACATTTTATGATTGGG -> GTACATTTTATGATTGGGA
ATCCCCTAGCTAGCGCAAA -> TCCCCTAGCTAGCGCAAAA
CCCTGCAGAACACAGCAGT -> CCTGCAGAACACAGCAGTG
GTACGGAGGTCGGTAAAAA -> TACGGAGGTCGGTAAAAAT
CATACTGCCGCCTCCATGG -> ATACTGCCGCCTCCATGGC
CGGTGCCCAATCCCAATCG -> GGTGCCCAATCCCAATCGA
CGTTACTTGAGTGTGACTC -> GTTACTTGAGTGTGACTCC
CTCTAGAGAAGCGCTCGCA -> TCTAGAGAAGCGCTCGCAA
GGTATCTTCATGTTAGTAA -> GTATCTTCATGTTAGTAAT
CCCGTGCGGGCTGACCCAC -> CCGTGCGGGCTGACCCACT
AGGGTGTCCGTGCGGTCGT -> GGGTGTCCGTGCGGTCGTG
ATGACCCTCTCGGATCTGT -> TGACCCTCTCGGATCTGTC
TTTACCTTATCATTACTCC -> TTACCTTATCATTACTCCT
CTTTAGACCCGTTTGATCA -> TTTAGACCCGTTTGATCAC
TGTATTCTGGGAATTCGAC -> GTATTCTGGGAATTCGACG
TGTGGCAACTGGCATACTG -> GTGGCAACTGGCATACTGC
CCATGGCTTCGAACAGGAC -> CATGGCTTCGAACAGGACA
TACAGATACGCCACCCACA -> ACAGATACGCCACCCACAG
GGAAGCATATCATCGGTAC -> GAAGCATATCATCGGTACC
AGTAAGGAAAAACAGGTCT -> GTAAGGAAAAACAGGTCTA
CTGAGCAATGCTGGGGTTG -> TGAGCAATGCTGGGGTTGG
CTGTGGACTCTCGTGCGGG -> TGTGGACTCTCGTGCGGGG
ACTCTTGCCTTCATCGGCA -> CTCTTGCCTTCATCGGCAG
TACTGTAGTTATATGCCCG -> ACTGTAGTTATATGCCCGT
CCACGTACTCAATTCAGCT -> CACGTACTCAATTCAGCTT
CGTGTCAGGCTTTGAGTAT -> GTGTCAGGCTTTGAGTATG
GTGCAGGACACACCTGCGT -> TGCAGGACACACCTGCGTT
TCTGGGAATTCGACGCTCC -> CTGGGAATTCGACGCTCCG
ACTTCAGTGCTTTACCTTA -> CTTCAGTGCTTTACCTTAT
CTGCATACACAGCGTGCCA -> TGCATACACAGCGTGCCAA
TCGAACACCAAGAGTACAT -> CGAACACCAAGAGTACATG
CCCCCGTTCGTCGACTCTT -> CCCCGTTCGTCGACTCTTG
CCGAGCCCCATGAGGAATA -> CGAGCCCCATGAGGAATAG
GTTTGAACCCGTGTCTGCT -> TTTGAACCCGTGTCTGCTG
AGGTCATACTCTAGAGAAG -> GGTCATACTCTAGAGAAGC
CACTTCAGTGCTTTACCTT -> ACTTCAGTGCTTTACCTTA
ATCGATCCGGAGGGAAAGG -> TCGATCCGGAGGGAAAGGA
TCTCATGGTTATCGTGCCT -> CTCATGGTTATCGTGCCTT
TCTTCATAAGTAAGCCACG -> CTTCATAAGTAAGCCACGA
AGACCAAGATACGCCACCC -> GACCAAGATACGCCACCCA
CGGATCTATCAGTCTAAGA -> GGATCTATCAGTCTAAGAT
CAGGCGACCGTACGATCGC -> AGGCGACCGTACGATCGCT
ATCGGCAGTGATGATTTCC -> TCGGCAGTGATGATTTCCG
ACACAGCGTGCGGTCTGCA -> CACAGCGTGCGGTCTGCAT
ATGGTCGCGTGTCAGGCTT -> TGGTCGCGTGTCAGGCTTT
CCCGTTATAACGTCCATCG -> CCGTTATAACGTCCATCGT
ACCGTACGATCGCTCAGTT -> CCGTACGATCGCTCAGTTT
TACCAAGTTTAGTACTAGC -> ACCAAGTTTAGTACTAGCC
GGACTCTCGTGCGGGGTTA -> GACTCTCGTGCGGGGTTAT
GGTAGTGGTCTGCATACAC -> GTAGTGGTCTGCATACACA
TATGATTGGGAGCAAGTAT -> ATGATTGGGAGCAAGTATA
ACACATGATTTCGCGCAGA -> CACATGATTTCGCGCAGAC
AGCAAGAGGACAGCGGTCT -> GCAAGAGGACAGCGGTCTG
CTGTACCATTTCTCAAGCG -> TGTACCATTTCTCAAGCGT
ATCGCTCAGTTTGGGCAAT -> TCGCTCAGTTTGGGCAATG
TCCGTGCGGTCGTGATTTC -> CCGTGCGGTCGTGATTTCC
TTGAGAACACTCCCTGCAG -> TGAGAACACTCCCTGCAGA
GGAAGGTCATACTCTAGAG -> GAAGGTCATACTCTAGAGA
CACTTGTTACCAGTACAGG -> ACTTGTTACCAGTACAGGT
GTGCGCTAGCAACACCCAC -> TGCGCTAGCAACACCCACT
ACTAGCCCTCCCCAGTCTT -> CTAGCCCTCCCCAGTCTTC
CCGTTTGAACCCGTGTCTG -> CGTTTGAACCCGTGTCTGC
CCCGGGACACTCACATTGT -> CCGGGACACTCACATTGTG
TATACGATCTTTCATTTCG -> ATACGATCTTTCATTTCGT
TAGACATGATCTTCAACTC -> AGACATGATCTTCAACTCC
TCGAACTGCAGCCCCCGTT -> CGAACTGCAGCCCCCGTTC
CGCGAGTGATAAAGTCTGG -> GCGAGTGATAAAGTCTGGA
GATTGGGAGCAAGTATAAA -> ATTGGGAGCAAGTATAAAG
GATATTTTACGATCAAGGG -> ATATTTTACGATCAAGGGC
CAGTACAGGTACTGTAGTT -> AGTACAGGTACTGTAGTTA
TATAACGTCCATCGTGCTG -> ATAACGTCCATCGTGCTGA
CTGCAGCCCCCGTTCGTCG -> TGCAGCCCCCGTTCGTCGA
AAAGCTTGTAGTGCGCTAG -> AAGCTTGTAGTGCGCTAGC
CGGAGGGAAAGGATTGTAT -> GGAGGGAAAGGATTGTATT
TCGCAACACTTCAGTGCTT -> CGCAACACTTCAGTGCTTT
GCGAAGGATGTCGTACACA -> CGAAGGATGTCGTACACAT
TGATAAAGTCTGGAGCTAG -> GATAAAGTCTGGAGCTAGG
GTGCCTTCGAGGGTGTCCG -> TGCCTTCGAGGGTGTCCGT
AGGAATAGACCAAGATACG -> GGAATAGACCAAGATACGC
CATGTGATATGTACGGAGG -> ATGTGATATGTACGGAGGT
CAGTGCTTTACCTTATCAT -> AGTGCTTTACCTTATCATT
AAAAGCCCCGCTTTGATGT -> AAAGCCCCGCTTTGATGTG
ACGCAGGAACCCGGGACAC -> CGCAGGAACCCGGGACACT
GTCACCGTCGGAAGGTCAT -> TCACCGTCGGAAGGTCATA
GGGGTCGACGGTGCAGGAC -> GGGTCGACGGTGCAGGACA
CGACGGTGCAGGACACACC -> GACGGTGCAGGACACACCT
GAGAACACTCCCTGCAGAA -> AGAACACTCCCTGCAGAAC
TCATTTCGTATGGCATTAA -> CATTTCGTATGGCATTAAA
GCATACACAGCGTGAGTCA -> CATACACAGCGTGAGTCAC
GACTGATTAATGGTGAGGC -> ACTGATTAATGGTGAGGCA
AGAACACTCCCTGCAGAAC -> GAACACTCCCTGCAGAACA
TTGCTCGTGAACAATGTAG -> TGCTCGTGAACAATGTAGG
CACCAACACACTGGTGTTC -> ACCAACACACTGGTGTTCA
CCACACAGTTCTACTGCCC -> CACACAGTTCTACTGCCCG
AACGCTGAACAGTCGGCTG -> ACGCTGAACAGTCGGCTGG
GTACTAGCCCTCCCCAGTC -> TACTAGCCCTCCCCAGTCT
CCATGAGGAATAGACCAAG -> CATGAGGAATAGACCAAGA
CTTGAGAACACTCCCTGCA -> TTGAGAACACTCCCTGCAG
TCTGCATACACAGCGTGCC -> CTGCATACACAGCGTGCCA
CCTTCATCGGCAGTGATGA -> CTTCATCGGCAGTGATGAT
CTTCAGTGCTTTACCTTAT -> TTCAGTGCTTTACCTTATC
TCTGCATACACAGCGTGCG -> CTGCATACACAGCGTGCGG
ACTCCCGTTTGAACCCGTG -> CTCCCGTTTGAACCCGTGT
CCCAATCGAGTAAATAGTA -> CCAATCGAGTAAATAGTAT
GAACTGCAGCCCCCGTTCG -> AACTGCAGCCCCCGTTCGT
ACCCAGACAATGCTTAGCG -> CCCAGACAATGCTTAGCGA
TGACTCCCGTTATAACGTC -> GACTCCCGTTATAACGTCC
AACCTCTTTAGACCCGTTT -> ACCTCTTTAGACCCGTTTG
CCCTCCCCAGTCTTCATAA -> CCTCCCCAGTCTTCATAAG
GACGTTGGCCGATTCTGGC -> ACGTTGGCCGATTCTGGCA
AGAATCTTAATAGTCGACT -> GAATCTTAATAGTCGACTC
TCTTAATAGTCGACTCCCG -> CTTAATAGTCGACTCCCGT
GTTATATGCCCGTGCGGGC -> TTATATGCCCGTGCGGGCT
TCGAGTAAATAGTATCCGT -> CGAGTAAATAGTATCCGTT
GCCCCGCTTTGATGTGGCC -> CCCCGCTTTGATGTGGCCA
CCCTCTCGGATCTGTCTTG -> CCTCTCGGATCTGTCTTGC
TCATATCGTCTAAACAGGC -> CATATCGTCTAAACAGGCG
ATCGTGCCTTCGAGGGTGT -> TCGTGCCTTCGAGGGTGTC
TTACAACTTCATTGACATA -> TACAACTTCATTGACATAA
TAATTAGGTGAATTGGAAT -> AATTAGGTGAATTGGAATA
GTTTCGCCTCAGCTGAGCA -> TTTCGCCTCAGCTGAGCAA
CCAATCCCAATCGAGTAAA -> CAATCCCAATCGAGTAAAT
GCGCTCTCGTACCAAGTTT -> CGCTCTCGTACCAAGTTTA
CGTGGCCTGTATACGATCT -> GTGGCCTGTATACGATCTT
TGAGTATGAACCTCTTTAG -> GAGTATGAACCTCTTTAGA
TTCCACGTACTCAATTCAG -> TCCACGTACTCAATTCAGC
ACTCACATTGTGGCAACTG -> CTCACATTGTGGCAACTGG
CCACCCACAGCAAGAGGAC -> CACCCACAGCAAGAGGACA
AACAGGACATGCCCAAATT -> ACAGGACATGCCCAAATTA
TTAGTAAGGAAAAACAGGT -> TAGTAAGGAAAAACAGGTC
TACGATCAAGGGCCGGGAT -> ACGATCAAGGGCCGGGATT
TAACTAGACCCAGACAATG -> AACTAGACCCAGACAATGC
CCCCTGTACCATTTCTCAA -> CCCTGTACCATTTCTCAAG
TCGGTAAAAATAACTATGT -> CGGTAAAAATAACTATGTA
AGGTAGTGGTCTGCATACA -> GGTAGTGGTCTGCATACAC
AAGCATGCGCTCTCGTACC -> AGCATGCGCTCTCGTACCA
AGGCCGACATTGAACTGAG -> GGCCGACATTGAACTGAGA
CCTCAGCTGAGCAATGCTG -> CTCAGCTGAGCAATGCTGG
CGACCGTACGATCGCTCAG -> GACCGTACGATCGCTCAGT
GTGGGACCGAGCCCCATGA -> TGGGACCGAGCCCCATGAG
CTGGCACCCTTGATATAGT -> TGGCACCCTTGATATAGTA
TGAACAGTCGGCTGGCAAG -> GAACAGTCGGCTGGCAAGC
GCGAGTCGAACTGCAGCCC -> CGAGTCGAACTGCAGCCCC
GGCCGACATTGAACTGAGA -> GCCGACATTGAACTGAGAC
ATTCTGGGAATTCGACGCT -> TTCTGGGAATTCGACGCTC
GTCGTGATTTCCCCATTCT -> TCGTGATTTCCCCATTCTG
ATAAGCCGGATCTATCAGT -> TAAGCCGGATCTATCAGTC
CACAGCGTTGAATTTGGGG -> ACAGCGTTGAATTTGGGGT
TATTTTACGATCAAGGGCC -> ATTTTACGATCAAGGGCCG
TAGGCTTAACTCACACCAA -> AGGCTTAACTCACACCAAC
GAGGTACTACCTCGCTTTA -> AGGTACTACCTCGCTTTAG
TGGCACCCTTGATATAGTA -> GGCACCCTTGATATAGTAG
CTAGAGAAGCGCTCGCAAC -> TAGAGAAGCGCTCGCAACA
TTTCGTATGGCATTAAACG -> TTCGTATGGCATTAAACGC
GCAGACATACGCAGGAACC -> CAGACATACGCAGGAACCC
GGGTGTCCGTGCGGTCGTG -> GGTGTCCGTGCGGTCGTGA
CAGTGACCATCCCTGACTA -> AGTGACCATCCCTGACTAC
CAGTGGGACCGAGCCCCAT -> AGTGGGACCGAGCCCCATG
CCGGAGGGAAAGGATTGTA -> CGGAGGGAAAGGATTGTAT
GCCAGCTAATGACCCTCTC -> CCAGCTAATGACCCTCTCG
CCTGACCCCTGTACCATTT -> CTGACCCCTGTACCATTTC
GGATCTATCAGTCTAAGAT -> GATCTATCAGTCTAAGATC
TCGGGCCGTCAATCGATCC -> CGGGCCGTCAATCGATCCG
CACCTTTAGCCAATATGGC -> ACCTTTAGCCAATATGGCC
GCGTGAGTCACCGTCGGAA -> CGTGAGTCACCGTCGGAAG
GTGCGGGCTGACCCACTAC -> TGCGGGCTGACCCACTACT
TTCAGCTTAGATAGGCCGA -> TCAGCTTAGATAGGCCGAC
GAATCTTAATAGTCGACTC -> AATCTTAATAGTCGACTCC
GACATTGAACTGAGACGCT -> ACATTGAACTGAGACGCTG
GGTGCCCAATCCCAATCGA -> GTGCCCAATCCCAATCGAG
TAGTCGACTCCCGTTTGAA -> AGTCGACTCCCGTTTGAAC
AACTCCCCAAAGCATGCGC -> ACTCCCCAAAGCATGCGCT
GCTGACCCACTACTTTACA -> CTGACCCACTACTTTACAC
CAATGTAGGATATTTTACG -> AATGTAGGATATTTTACGA
TATAAAGCGTCTCATGGTT -> ATAAAGCGTCTCATGGTTA
CATTAAACGCTGAACAGTC -> ATTAAACGCTGAACAGTCG
ATCGAGTAAATAGTATCCG -> TCGAGTAAATAGTATCCGT
GAGGACAGCGGTCTGCATA -> AGGACAGCGGTCTGCATAC
ATCCGCGTGTCGTGTGACC -> TCCGCGTGTCGTGTGACCG
GCAACACCCACTTGTTACC -> CAACACCCACTTGTTACCA
ACCAAGAGTACATGCGAGT -> CCAAGAGTACATGCGAGTC
GGGCCGGTACATTTTATGA -> GGCCGGTACATTTTATGAT
AGGTGAATTGGAATAGATA -> GGTGAATTGGAATAGATAC
GACCAAGATACGCCACCCA -> ACCAAGATACGCCACCCAC
ATTTCTCAAGCGTCGAACA -> TTTCTCAAGCGTCGAACAC
CTCTCCGCCTGCAGAATCT -> TCTCCGCCTGCAGAATCTT
GCTGTGGACTCTCGTGCGG -> CTGTGGACTCTCGTGCGGG
GTACCATTTCTCAAGCGTC -> TACCATTTCTCAAGCGTCG
GAATAGACCAAGATACGCC -> AATAGACCAAGATACGCCA
TTTAGACCCGTTTGATCAC -> TTAGACCCGTTTGATCACC
GCTTAGATAGGCCGACATT -> CTTAGATAGGCCGACATTG
AGCATGCGCTCTCGTACCA -> GCATGCGCTCTCGTACCAA
TCCCGGTAGCTCTCCGCCT -> CCCGGTAGCTCTCCGCCTG
TACTCCTCGGGCCGGTACA -> ACTCCTCGGGCCGGTACAT
TAGCCAATATGGCCGATTG -> AGCCAATATGGCCGATTGT
AATAGTCGACTCCCGTTTG -> ATAGTCGACTCCCGTTTGA
GTGACCGTTACTTGAGTGT -> TGACCGTTACTTGAGTGTG
ATAACGTCCATCGTGCTGA -> TAACGTCCATCGTGCTGAT
AATGCTTGAATAGATTAAA -> ATGCTTGAATAGATTAAAT
CTAAGATCACGACTTTTTG -> TAAGATCACGACTTTTTGA
TCCCGTTTGAACCCGTGTC -> CCCGTTTGAACCCGTGTCT
TTATCGTGCCTTCGAGGGT -> TATCGTGCCTTCGAGGGTG
TATGGCTGGTATCTTCATG -> ATGGCTGGTATCTTCATGT
TTCACTTTGAGTCTTAGTA -> TCACTTTGAGTCTTAGTAA
AAAAAAATGCTTGAATAGA -> AAAAAATGCTTGAATAGAT
TTGTAGCCATCACTATGAC -> TGTAGCCATCACTATGACG
CGATCAAGGGCCGGGATTA -> GATCAAGGGCCGGGATTAG
TACAGGTACTGTAGTTATA -> ACAGGTACTGTAGTTATAT
TAGGCCGACATTGAACTGA -> AGGCCGACATTGAACTGAG
CCCATTCTGGTGATAGTCC -> CCATTCTGGTGATAGTCCC
TAGATACGCCACCCACAGC -> AGATACGCCACCCACAGCT
GCCTTCGAGGGTGTCCGTG -> CCTTCGAGGGTGTCCGTGC
ACTATGACGTTGGCCGATT -> CTATGACGTTGGCCGATTC
GTGAGTCACCGTCGGAAGG -> TGAGTCACCGTCGGAAGGT
GGAACCCGGGACACTCACA -> GAACCCGGGACACTCACAT
CCCTGTAGTTGGTTTCCAC -> CCTGTAGTTGGTTTCCACG
GAACTGAGACGCTGTGTGG -> AACTGAGACGCTGTGTGGA
ACATTTTATGATTGGGAGC -> CATTTTATGATTGGGAGCA
GTTGATGCAGGAACCGTCT -> TTGATGCAGGAACCGTCTA
TCTTGCCTTCATCGGCAGT -> CTTGCCTTCATCGGCAGTG
ATATGGCCGATTGTTAACG -> TATGGCCGATTGTTAACGT
CTGATGTTGATGCAGGAAC -> TGATGTTGATGCAGGAACC
GTACAGGTACTGTAGTTAT -> TACAGGTACTGTAGTTATA
ATGAACCTCTTTAGACCCG -> TGAACCTCTTTAGACCCGT
CGGTACCCCCATGGTCGCG -> GGTACCCCCATGGTCGCGT
ATGTGATATGTACGGAGGT -> TGTGATATGTACGGAGGTC
CGCCTCCATGGCTTCGAAC -> GCCTCCATGGCTTCGAACA
TTTAGTCTCGACGTCCCGG -> TTAGTCTCGACGTCCCGGT
CGCAGACATACGCAGGAAC -> GCAGACATACGCAGGAACC
GGAATAGACCAAGATACGC -> GAATAGACCAAGATACGCC
CAAGCGTCGAACACCAAGA -> AAGCGTCGAACACCAAGAG
TCCTCGGGCCGTCAATCGA -> CCTCGGGCCGTCAATCGAT
CGTTGGCCGATTCTGGCAC -> GTTGGCCGATTCTGGCACC
ATTGACATAACTAGACCCA -> TTGACATAACTAGACCCAG
TCGTACACATGATTTCGCG -> CGTACACATGATTTCGCGC
TGGTCTGCATACACAGCGT -> GGTCTGCATACACAGCGTG
TCGCGTGTCAGGCTTTGAG -> CGCGTGTCAGGCTTTGAGT
TTTGAGGTACTACCTCGCT -> TTGAGGTACTACCTCGCTT
TTGTGGCAACTGGCATACT -> TGTGGCAACTGGCATACTG
CCCAAATTAATCCGCGTGT -> CCAAATTAATCCGCGTGTC
TGAGACGCTGTGTGGATAA -> GAGACGCTGTGTGGATAAG
TTGACATAACTAGACCCAG -> TGACATAACTAGACCCAGA
ATTTCGTATGGCATTAAAC -> TTTCGTATGGCATTAAACG
ACTTGTTCCCGTCTAGATT -> CTTGTTCCCGTCTAGATTT
GGTGAGATACGCCACCCAC -> GTGAGATACGCCACCCACA
GGAATTCGACGCTCCGGCT -> GAATTCGACGCTCCGGCTG
AAGTTTAGTACTAGCCCTC -> AGTTTAGTACTAGCCCTCC
TCTACTGCCCGAGAGAAAA -> CTACTGCCCGAGAGAAAAT
GACGCTGTGTGGATAAGCC -> ACGCTGTGTGGATAAGCCG
CCCCTAGCTAGCGCAAAAA -> CCCTAGCTAGCGCAAAAAA
CTCGGATCTGTCTTGCCTA -> TCGGATCTGTCTTGCCTAC
GTCAATCGATCCGGAGGGA -> TCAATCGATCCGGAGGGAA
AAATTAAAAGCCCCGCTTT -> AATTAAAAGCCCCGCTTTG
ATGTGGCCAATCGGTGCCC -> TGTGGCCAATCGGTGCCCA
GTCGTGTGACCGTTACTTG -> TCGTGTGACCGTTACTTGA
CATACTCTAGAGAAGCGCT -> ATACTCTAGAGAAGCGCTC
AAGTAAGCCACGACTGATT -> AGTAAGCCACGACTGATTA
GTGGCCTGTATACGATCTT -> TGGCCTGTATACGATCTTT
AGGACATGCCCAAATTAAT -> GGACATGCCCAAATTAATC
AAAAATGCTTGAATAGATT -> AAAATGCTTGAATAGATTA
TTAATGGTGAGGCACGTTA -> TAATGGTGAGGCACGTTAC
GTGATGATTTCCGAAGAAC -> TGATGATTTCCGAAGAACT
CCGATTCTGGCACCCTTGA -> CGATTCTGGCACCCTTGAT
GTAGTTATATGCCCGTGCG -> TAGTTATATGCCCGTGCGG
TTAGACATGATCTTCAACT -> TAGACATGATCTTCAACTC
TTGAACTGAGACGCTGTGT -> TGAACTGAGACGCTGTGTG
GATATGTACGGAGGTCGGT -> ATATGTACGGAGGTCGGTA
GCCCAATCCCAATCGAGTA -> CCCAATCCCAATCGAGTAA
GATCTGTCTTGCCTACCTT -> ATCTGTCTTGCCTACCTTG
GATTAATGGTGAGGCACGT -> ATTAATGGTGAGGCACGTT
TCAAATTTGCTCGTGAACA -> CAAATTTGCTCGTGAACAA
TCCCCAGGACCTCAGGGGT -> CCCCAGGACCTCAGGGGTC
TATCGTCTAAACAGGCGAC -> ATCGTCTAAACAGGCGACC
TCTCAAGCGTCGAACACCA -> CTCAAGCGTCGAACACCAA
TCTTCAACTCCCCAAAGCA -> CTTCAACTCCCCAAAGCAT
TCCTGATGCCGACGCAAAT -> CCTGATGCCGACGCAAATA
TGTTCACTTTGAGTCTTAG -> GTTCACTTTGAGTCTTAGT
GCTTTGAGTATGAACCTCT -> CTTTGAGTATGAACCTCTT
AGCTTAGATAGGCCGACAT -> GCTTAGATAGGCCGACATT
AATTGGAATAGATACGCCA -> ATTGGAATAGATACGCCAC
CTGCTTTTATCCCCACACA -> TGCTTTTATCCCCACACAG
ACTCCCGTTATAACGTCCA -> CTCCCGTTATAACGTCCAT
ATACAGATACGCCACCCAC -> TACAGATACGCCACCCACA
ATTAAGGGTACATACTCTC -> TTAAGGGTACATACTCTCA
CCCCAAAGCATGCGCTCTC -> CCCAAAGCATGCGCTCTCG
CAAAAAAATGCTTGAATAG -> AAAAAAATGCTTGAATAGA
CCCGCTTTGATGTGGCCAA -> CCGCTTTGATGTGGCCAAT
CTTGTTACCAGTACAGGTA -> TTGTTACCAGTACAGGTAC
CCGTGTGGATTAGACATGA -> CGTGTGGATTAGACATGAT
TCCGGAGGGAAAGGATTGT -> CCGGAGGGAAAGGATTGTA
CCAAGTTTAGTACTAGCCC -> CAAGTTTAGTACTAGCCCT
CAGTTTGGGCAATGTCAAA -> AGTTTGGGCAATGTCAAAT
ACCCACTTGTTACCAGTAC -> CCCACTTGTTACCAGTACA
TATCATATCGTCTAAACAG -> ATCATATCGTCTAAACAGG
CCAGTCTTCATAAGTAAGC -> CAGTCTTCATAAGTAAGCC
GTTATCGTGCCTTCGAGGG -> TTATCGTGCCTTCGAGGGT
CCGTGTCTGCTGCTTTTAT -> CGTGTCTGCTGCTTTTATC
AAGCCGGATCTATCAGTCT -> AGCCGGATCTATCAGTCTA
ATGCTGGGGTTGGCATGTG -> TGCTGGGGTTGGCATGTGA
CGACATTGAACTGAGACGC -> GACATTGAACTGAGACGCT
TCATACTCTAGAGAAGCGC -> CATACTCTAGAGAAGCGCT
CGCAAAAAAATGCTTGAAT -> GCAAAAAAATGCTTGAATA
GGCAAGCCAGCTAATGACC -> GCAAGCCAGCTAATGACCC
TCAGCTTAGATAGGCCGAC -> CAGCTTAGATAGGCCGACA
CCTGTTGCGGTGAGATACG -> CTGTTGCGGTGAGATACGC
TACTCAATTCAGCTTAGAT -> ACTCAATTCAGCTTAGATA
GGGGTTGGCATGTGATATG -> GGGTTGGCATGTGATATGT
AGACCCGTTTGATCACCAT -> GACCCGTTTGATCACCATC
AAGCGCTCGCAACACTTCA -> AGCGCTCGCAACACTTCAG
CACAGCCTGTTGCGGTGAG -> ACAGCCTGTTGCGGTGAGA
GTGGACTCTCGTGCGGGGT -> TGGACTCTCGTGCGGGGTT
TTCTGGCACCCTTGATATA -> TCTGGCACCCTTGATATAG
CCACTTGTTACCAGTACAG -> CACTTGTTACCAGTACAGG
AGTATGAACCTCTTTAGAC -> GTATGAACCTCTTTAGACC
ACAGGTCTAGATTAAGGGT -> CAGGTCTAGATTAAGGGTA
TTTGATCACCATCCCCTAG -> TTGATCACCATCCCCTAGC
GACATGATCTTCAACTCCC -> ACATGATCTTCAACTCCCC
TGATTTCCCCATTCTGGTG -> GATTTCCCCATTCTGGTGA
CGCAAATATGAGGCCCGCG -> GCAAATATGAGGCCCGCGA
GTGTCTGCTGCTTTTATCC -> TGTCTGCTGCTTTTATCCC
GTGAATTGGAATAGATACG -> TGAATTGGAATAGATACGC
AGATTAAATCCTCGGGCCG -> GATTAAATCCTCGGGCCGT
TTACACCTTTAGCCAATAT -> TACACCTTTAGCCAATATG
TCTCGTACCAAGTTTAGTA -> CTCGTACCAAGTTTAGTAC
CGAGGGTGTCCGTGCGGTC -> GAGGGTGTCCGTGCGGTCG
CGCTCGCAACACTTCAGTG -> GCTCGCAACACTTCAGTGC
CCGCCTGCAGAATCTTAAT -> CGCCTGCAGAATCTTAATA
GAGGAATAGACCAAGATAC -> AGGAATAGACCAAGATACG
CATATCATCGGTACCCCCA -> ATATCATCGGTACCCCCAT
ATACACAGCGTGCGGTCTG -> TACACAGCGTGCGGTCTGC
AGGATTGTATTCTGGGAAT -> GGATTGTATTCTGGGAATT
CAAGTATAAAGCGTCTCAT -> AAGTATAAAGCGTCTCATG
GCCCTCCCCAGTCTTCATA -> CCCTCCCCAGTCTTCATAA
CGAGGAAGCATATCATCGG -> GAGGAAGCATATCATCGGT
CAACCCAGTGACCATCCCT -> AACCCAGTGACCATCCCTG
TGGAATAGATACGCCACCC -> GGAATAGATACGCCACCCA
GCCGGTACATTTTATGATT -> CCGGTACATTTTATGATTG
TTGGAATAGATACGCCACC -> TGGAATAGATACGCCACCC
TGTTGATGCAGGAACCGTC -> GTTGATGCAGGAACCGTCT
CAGCTAATGACCCTCTCGG -> AGCTAATGACCCTCTCGGA
CACCCACAGCTTTTAGGTA -> ACCCACAGCTTTTAGGTAG
TGAGGCCCGCGAGTGATAA -> GAGGCCCGCGAGTGATAAA
AATATGGCCGATTGTTAAC -> ATATGGCCGATTGTTAACG
CTATGTACGATAGGTAGAC -> TATGTACGATAGGTAGACG
GAATTTGGGGTCTGCATAC -> AATTTGGGGTCTGCATACA
TGGCCGATTGTTAACGTAA -> GGCCGATTGTTAACGTAAA
GTCCGTGCGGTCGTGATTT -> TCCGTGCGGTCGTGATTTC
CGGCAGTGATGATTTCCGA -> GGCAGTGATGATTTCCGAA
CATCACTATGACGTTGGCC -> ATCACTATGACGTTGGCCG
CGATACAGATACGCCACCC -> GATACAGATACGCCACCCA
TCGAACAGGACATGCCCAA -> CGAACAGGACATGCCCAAA
GCCACCCACAGCCTGTTGC -> CCACCCACAGCCTGTTGCG
AAGGTCATACTCTAGAGAA -> AGGTCATACTCTAGAGAAG
AAGCTTGTAGTGCGCTAGC -> AGCTTGTAGTGCGCTAGCA
CTTAATAGTCGACTCCCGT -> TTAATAGTCGACTCCCGTT
GGCTGGTATCTTCATGTTA -> GCTGGTATCTTCATGTTAG
CACCCACAGCAAGAGGACA -> ACCCACAGCAAGAGGACAG
TGCGGTGAGATACGCCACC -> GCGGTGAGATACGCCACCC
GTGTTCACTTTGAGTCTTA -> TGTTCACTTTGAGTCTTAG
AATCCCAATCGAGTAAATA -> ATCCCAATCGAGTAAATAG
ACAGCAAGAGGACAGCGGT -> CAGCAAGAGGACAGCGGTC
AATCGGTGCCCAATCCCAA -> ATCGGTGCCCAATCCCAAT
CTCCCTGCAGAACACAGCA -> TCCCTGCAGAACACAGCAG
ACGATCTTTCATTTCGTAT -> CGATCTTTCATTTCGTATG
GACGCTCCGGCTGTGGACT -> ACGCTCCGGCTGTGGACTC
TTTAGGTAGTGGTCTGCAT -> TTAGGTAGTGGTCTGCATA
CGAACTGCAGCCCCCGTTC -> GAACTGCAGCCCCCGTTCG
AAATTTGCTCGTGAACAAT -> AATTTGCTCGTGAACAATG
AAACAGGTCTAGATTAAGG -> AACAGGTCTAGATTAAGGG
AGTCGACTCCCGTTTGAAC -> GTCGACTCCCGTTTGAACC
AAAGCCCCGCTTTGATGTG -> AAGCCCCGCTTTGATGTGG
CATTTTATGATTGGGAGCA -> ATTTTATGATTGGGAGCAA
GAGAAGCGCTCGCAACACT -> AGAAGCGCTCGCAACACTT
TGTACCATTTCTCAAGCGT -> GTACCATTTCTCAAGCGTC
GTGGTCTGCATACACAGCG -> TGGTCTGCATACACAGCGT
CACCCACAGCGTTGAATTT -> ACCCACAGCGTTGAATTTG
GACCTCAGGGGTCGACGGT -> ACCTCAGGGGTCGACGGTG
TATGACGTTGGCCGATTCT -> ATGACGTTGGCCGATTCTG
AATGGGCGAATGACACGCG -> ATGGGCGAATGACACGCGA
CCTCCCCAGTCTTCATAAG -> CTCCCCAGTCTTCATAAGT
TGCATACACAGCGTGCGGT -> GCATACACAGCGTGCGGTC
CGTGTGACCGTTACTTGAG -> GTGTGACCGTTACTTGAGT
CACTGGTGTTCACTTTGAG -> ACTGGTGTTCACTTTGAGT
TTTCATTTCGTATGGCATT -> TTCATTTCGTATGGCATTA
ACTTTACACCTTTAGCCAA -> CTTTACACCTTTAGCCAAT
CGGTCTGCATACACAGCGT -> GGTCTGCATACACAGCGTG,GGTCTGCATACACAGCGTG
TGGACTCTCGTGCGGGGTT -> GGACTCTCGTGCGGGGTTA
ATCCTGACCCCTGTACCAT -> TCCTGACCCCTGTACCATT
TCCGCGTGTCGTGTGACCG -> CCGCGTGTCGTGTGACCGT
ACATGATTTCGCGCAGACA -> CATGATTTCGCGCAGACAT
CGACTTTTTGAGGTACTAC -> GACTTTTTGAGGTACTACC
GCTTTACCTTATCATTACT -> CTTTACCTTATCATTACTC
TAAACGCTGAACAGTCGGC -> AAACGCTGAACAGTCGGCT
TAACTATGTACGATAGGTA -> AACTATGTACGATAGGTAG
TATGAGGCCCGCGAGTGAT -> ATGAGGCCCGCGAGTGATA
TGGCAACTGGCATACTGCC -> GGCAACTGGCATACTGCCG
TCGACTCCCGTTTGAACCC -> CGACTCCCGTTTGAACCCG
TCTGCATACACAGCGTGAG -> CTGCATACACAGCGTGAGT
TAGACCCCGTGTGGATTAG -> AGACCCCGTGTGGATTAGA
AAGATCACGACTTTTTGAG -> AGATCACGACTTTTTGAGG
CCACAGCGTTGAATTTGGG -> CACAGCGTTGAATTTGGGG
TACGCCACCCACAGCCTGT -> ACGCCACCCACAGCCTGTT
ATGGCTGGTATCTTCATGT -> TGGCTGGTATCTTCATGTT
GAGCAATGCTGGGGTTGGC -> AGCAATGCTGGGGTTGGCA
CCGTTCGTCGACTCTTGCC -> CGTTCGTCGACTCTTGCCT
ATATGCCCGTGCGGGCTGA -> TATGCCCGTGCGGGCTGAC
TTAACTCACACCAACACAC -> TAACTCACACCAACACACT
GAATTCGACGCTCCGGCTG -> AATTCGACGCTCCGGCTGT
TGGTGAGGCACGTTACTCC -> GGTGAGGCACGTTACTCCT
GACGCAAATATGAGGCCCG -> ACGCAAATATGAGGCCCGC
GGCCGGGATTAGACCGATA -> GCCGGGATTAGACCGATAC
CCACAGCTTTTAGGTAGTG -> CACAGCTTTTAGGTAGTGG
TTAGGTAGTGGTCTGCATA -> TAGGTAGTGGTCTGCATAC
CCCACACAGTTCTACTGCC -> CCACACAGTTCTACTGCCC
GCAAGTATAAAGCGTCTCA -> CAAGTATAAAGCGTCTCAT
ACCTCAGGGGTCGACGGTG -> CCTCAGGGGTCGACGGTGC
CGACGTCCCGGTAGCTCTC -> GACGTCCCGGTAGCTCTCC
TGCTCGTGAACAATGTAGG -> GCTCGTGAACAATGTAGGA
GCCACCCACAGCTTTTAGG -> CCACCCACAGCTTTTAGGT
TGACCCTCTCGGATCTGTC -> GACCCTCTCGGATCTGTCT
TGGCATACTGCCGCCTCCA -> GGCATACTGCCGCCTCCAT
GGATAAGCCGGATCTATCA -> GATAAGCCGGATCTATCAG
CAGAATCTTAATAGTCGAC -> AGAATCTTAATAGTCGACT
TAACTCACACCAACACACT -> AACTCACACCAACACACTG
ACCGTTACTTGAGTGTGAC -> CCGTTACTTGAGTGTGACT
GTACACATGATTTCGCGCA -> TACACATGATTTCGCGCAG
AGGTACTGTAGTTATATGC -> GGTACTGTAGTTATATGCC
GTGATAGTCCCTGTAGTTG -> TGATAGTCCCTGTAGTTGG
GCCCGTGCGGGCTGACCCA -> CCCGTGCGGGCTGACCCAC
GAACACAGCAGTGGGACCG -> AACACAGCAGTGGGACCGA
AGATTTCCCCAGGACCTCA -> GATTTCCCCAGGACCTCAG
CAATCGGTGCCCAATCCCA -> AATCGGTGCCCAATCCCAA
TCGGCTGGCAAGCCAGCTA -> CGGCTGGCAAGCCAGCTAA
ACGTCCCGGTAGCTCTCCG -> CGTCCCGGTAGCTCTCCGC
AACACAGCAGTGGGACCGA -> ACACAGCAGTGGGACCGAG
CATAACTAGACCCAGACAA -> ATAACTAGACCCAGACAAT
TTGCGGTGAGATACGCCAC -> TGCGGTGAGATACGCCACC
ACCGTCGGAAGGTCATACT -> CCGTCGGAAGGTCATACTC
CTCAGTTTGGGCAATGTCA -> TCAGTTTGGGCAATGTCAA
TTAGCGAAGGATGTCGTAC -> TAGCGAAGGATGTCGTACA
GCATACTGCCGCCTCCATG -> CATACTGCCGCCTCCATGG
GCCCCCGTTCGTCGACTCT -> CCCCCGTTCGTCGACTCTT
TAAAATGGGCGAATGACAC -> AAAATGGGCGAATGACACG
GGTCGTGATTTCCCCATTC -> GTCGTGATTTCCCCATTCT
GGCAGTGATGATTTCCGAA -> GCAGTGATGATTTCCGAAG
ACCCACTACTTTACACCTT -> CCCACTACTTTACACCTTT
ATTTCCCCATTCTGGTGAT -> TTTCCCCATTCTGGTGATA
TAGATTAAGGGTACATACT -> AGATTAAGGGTACATACTC
GCAAATATGAGGCCCGCGA -> CAAATATGAGGCCCGCGAG
TGGGACCGAGCCCCATGAG -> GGGACCGAGCCCCATGAGG
CGTGCGGGCTGACCCACTA -> GTGCGGGCTGACCCACTAC
TCGGCAGTGATGATTTCCG -> CGGCAGTGATGATTTCCGA
CCTGCGTTGTAAGGCTATC -> CTGCGTTGTAAGGCTATCA
TGCCAACCCAGTGACCATC -> GCCAACCCAGTGACCATCC
GCCGGATCTATCAGTCTAA -> CCGGATCTATCAGTCTAAG
GTTACTTGAGTGTGACTCC -> TTACTTGAGTGTGACTCCC
ACCATTTCTCAAGCGTCGA -> CCATTTCTCAAGCGTCGAA
CTGAGACGCTGTGTGGATA -> TGAGACGCTGTGTGGATAA
CCTTATCATTACTCCTGAT -> CTTATCATTACTCCTGATG
AGCGTGGCCTGTATACGAT -> GCGTGGCCTGTATACGATC
CAAGAGTACATGCGAGTCG -> AAGAGTACATGCGAGTCGA
CTTTACACCTTTAGCCAAT -> TTTACACCTTTAGCCAATA
TAAAGCGTCTCATGGTTAT -> AAAGCGTCTCATGGTTATC
GTATTCTGGGAATTCGACG -> TATTCTGGGAATTCGACGC
TACGATCGCTCAGTTTGGG -> ACGATCGCTCAGTTTGGGC
AGCGTCTCATGGTTATCGT -> GCGTCTCATGGTTATCGTG
GCTCAGTTTGGGCAATGTC -> CTCAGTTTGGGCAATGTCA
TTAATCCGCGTGTCGTGTG -> TAATCCGCGTGTCGTGTGA
ACATAACTAGACCCAGACA -> CATAACTAGACCCAGACAA
ACTCCTCGGGCCGGTACAT -> CTCCTCGGGCCGGTACATT
GGGTCTGCATACACAGCGT -> GGTCTGCATACACAGCGTG
TAGGTAGACGAGGAAGCAT -> AGGTAGACGAGGAAGCATA
TAAAAATAACTATGTACGA -> AAAAATAACTATGTACGAT
TCTCGTGCGGGGTTATGAC -> CTCGTGCGGGGTTATGACT
CTGGGGTTGGCATGTGATA -> TGGGGTTGGCATGTGATAT
ACAGTCCCAAAATTAAAAG -> CAGTCCCAAAATTAAAAGC
TTCATCGGCAGTGATGATT -> TCATCGGCAGTGATGATTT
AGTCGGCTGGCAAGCCAGC -> GTCGGCTGGCAAGCCAGCT
TGCCGACGCAAATATGAGG -> GCCGACGCAAATATGAGGC
GATTTCGCGCAGACATACG -> ATTTCGCGCAGACATACGC
GCTGATGTTGATGCAGGAA -> CTGATGTTGATGCAGGAAC
TGATTTCGCGCAGACATAC -> GATTTCGCGCAGACATACG
TGATGATTTCCGAAGAACT -> GATGATTTCCGAAGAACTT
GGCGACCGTACGATCGCTC -> GCGACCGTACGATCGCTCA
CGCTTTGATGTGGCCAATC -> GCTTTGATGTGGCCAATCG
CTGGTATCTTCATGTTAGT -> TGGTATCTTCATGTTAGTA
TAACGTAAAATGGGCGAAT -> AACGTAAAATGGGCGAATG
CGTACCAAGTTTAGTACTA -> GTACCAAGTTTAGTACTAG
GCCGCCTCCATGGCTTCGA -> CCGCCTCCATGGCTTCGAA
GTAGGATATTTTACGATCA -> TAGGATATTTTACGATCAA
TCCCCAGTCTTCATAAGTA -> CCCCAGTCTTCATAAGTAA
GCTAGGCTTAACTCACACC -> CTAGGCTTAACTCACACCA
CATACACAGCGTGGCCTGT -> ATACACAGCGTGGCCTGTA
AAAGTCTGGAGCTAGGCTT -> AAGTCTGGAGCTAGGCTTA
GCATATCATCGGTACCCCC -> CATATCATCGGTACCCCCA
TTTGTAGCCATCACTATGA -> TTGTAGCCATCACTATGAC
CCAGTGACCATCCCTGACT -> CAGTGACCATCCCTGACTA
CTATGACGTTGGCCGATTC -> TATGACGTTGGCCGATTCT
CTGTCTTGCCTACCTTGTT -> TGTCTTGCCTACCTTGTTT
TCTTCATGTTAGTAATTAG -> CTTCATGTTAGTAATTAGG
CTCGTGAACAATGTAGGAT -> TCGTGAACAATGTAGGATA
CACAGCAAGAGGACAGCGG -> ACAGCAAGAGGACAGCGGT
GCGGGGTTATGACTTGTTC -> CGGGGTTATGACTTGTTCC
CAGCGTGCGGTCTGCATAC -> AGCGTGCGGTCTGCATACA
ATGGTGAGGCACGTTACTC -> TGGTGAGGCACGTTACTCC
GATTTCCGAAGAACTTATG -> ATTTCCGAAGAACTTATGC
TTTGAGTATGAACCTCTTT -> TTGAGTATGAACCTCTTTA
ATCAAGGGCCGGGATTAGA -> TCAAGGGCCGGGATTAGAC
AAGGGTACATACTCTCATC -> AGGGTACATACTCTCATCC
CCCGTGTGGATTAGACATG -> CCGTGTGGATTAGACATGA
TGCTTACAACTTCATTGAC -> GCTTACAACTTCATTGACA
GCCAATCGGTGCCCAATCC -> CCAATCGGTGCCCAATCCC
ATCGGTGCCCAATCCCAAT -> TCGGTGCCCAATCCCAATC
AGTCACCGTCGGAAGGTCA -> GTCACCGTCGGAAGGTCAT
CACAGCGTGGCCTGTATAC -> ACAGCGTGGCCTGTATACG
GCTATCATATCGTCTAAAC -> CTATCATATCGTCTAAACA
GCGGTCTGCATACACAGCG -> CGGTCTGCATACACAGCGT,CGGTCTGCATACACAGCGT
TCCACGTACTCAATTCAGC -> CCACGTACTCAATTCAGCT
TTCCCCATTCTGGTGATAG -> TCCCCATTCTGGTGATAGT
TTAAACGCTGAACAGTCGG -> TAAACGCTGAACAGTCGGC
AATAACTATGTACGATAGG -> ATAACTATGTACGATAGGT
AATTTGCTCGTGAACAATG -> ATTTGCTCGTGAACAATGT
GGCATGTGATATGTACGGA -> GCATGTGATATGTACGGAG
GAAGCGCTCGCAACACTTC -> AAGCGCTCGCAACACTTCA
GCGAGTGATAAAGTCTGGA -> CGAGTGATAAAGTCTGGAG
CGGTACATTTTATGATTGG -> GGTACATTTTATGATTGGG
GTTGCGGTGAGATACGCCA -> TTGCGGTGAGATACGCCAC
CGATCTTTCATTTCGTATG -> GATCTTTCATTTCGTATGG
TAGCGCAAAAAAATGCTTG -> AGCGCAAAAAAATGCTTGA
GTACGATCGCTCAGTTTGG -> TACGATCGCTCAGTTTGGG
CATGATTTCGCGCAGACAT -> ATGATTTCGCGCAGACATA
CATACACAGCGTGAGTCAC -> ATACACAGCGTGAGTCACC
CCGTGCGGTCGTGATTTCC -> CGTGCGGTCGTGATTTCCC
TTGTTAACGTAAAATGGGC -> TGTTAACGTAAAATGGGCG
CTGTAGTTGGTTTCCACGT -> TGTAGTTGGTTTCCACGTA
GATTAAGGGTACATACTCT -> ATTAAGGGTACATACTCTC
TGCTGGGGTTGGCATGTGA -> GCTGGGGTTGGCATGTGAT
TGGTTTCCACGTACTCAAT -> GGTTTCCACGTACTCAATT
ACTTTGAGTCTTAGTAAGG -> CTTTGAGTCTTAGTAAGGA
GAACCGTCTAGACCCCGTG -> AACCGTCTAGACCCCGTGT
CACCCTTGATATAGTAGGA -> ACCCTTGATATAGTAGGAC
AGGCCCGCGAGTGATAAAG -> GGCCCGCGAGTGATAAAGT
CGTTCGTCGACTCTTGCCT -> GTTCGTCGACTCTTGCCTT
GATACGCCACCCACAGCGT -> ATACGCCACCCACAGCGTT
ATCAGTCTAAGATCACGAC -> TCAGTCTAAGATCACGACT
TGATGTGGCCAATCGGTGC -> GATGTGGCCAATCGGTGCC
GTAAGCCACGACTGATTAA -> TAAGCCACGACTGATTAAT
GACCATCCCTGACTACTAA -> ACCATCCCTGACTACTAAA
CGTACGATCGCTCAGTTTG -> GTACGATCGCTCAGTTTGG
ATTAATCCGCGTGTCGTGT -> TTAATCCGCGTGTCGTGTG
GGATATTTTACGATCAAGG -> GATATTTTACGATCAAGGG
ATGGCCGATTGTTAACGTA -> TGGCCGATTGTTAACGTAA
GTATGGCTGGTATCTTCAT -> TATGGCTGGTATCTTCATG
GAAAGGATTGTATTCTGGG -> AAAGGATTGTATTCTGGGA
GCGTGCCAACCCAGTGACC -> CGTGCCAACCCAGTGACCA
CCCGTCTAGATTTCCCCAG -> CCGTCTAGATTTCCCCAGG
GTGTCAGGCTTTGAGTATG -> TGTCAGGCTTTGAGTATGA
ACGCCACCCACAGCCTGTT -> CGCCACCCACAGCCTGTTG
TAGCTAGCGCAAAAAAATG -> AGCTAGCGCAAAAAAATGC
TTGGGAGCAAGTATAAAGC -> TGGGAGCAAGTATAAAGCG
TAGGACAGTCCCAAAATTA -> AGGACAGTCCCAAAATTAA
CGCTTTAGTCTCGACGTCC -> GCTTTAGTCTCGACGTCCC
TAGTCCCTGTAGTTGGTTT -> AGTCCCTGTAGTTGGTTTC
TGTTACCAGTACAGGTACT -> GTTACCAGTACAGGTACTG
AACCCGTGTCTGCTGCTTT -> ACCCGTGTCTGCTGCTTTT
GCTTAACTCACACCAACAC -> CTTAACTCACACCAACACA
AATCCGCGTGTCGTGTGAC -> ATCCGCGTGTCGTGTGACC
CATACACAGCGTGCGGTCT -> ATACACAGCGTGCGGTCTG
ATTTCGCGCAGACATACGC -> TTTCGCGCAGACATACGCA
TGCAGCCCCCGTTCGTCGA -> GCAGCCCCCGTTCGTCGAC
ACACTGGTGTTCACTTTGA -> CACTGGTGTTCACTTTGAG
TTGTTACCAGTACAGGTAC -> TGTTACCAGTACAGGTACT
GTGACCATCCCTGACTACT -> TGACCATCCCTGACTACTA
TGGGGTCTGCATACACAGC -> GGGGTCTGCATACACAGCG
CTTCATGTTAGTAATTAGG -> TTCATGTTAGTAATTAGGT
TACTGCCCGAGAGAAAATC -> ACTGCCCGAGAGAAAATCT
AGGAAGCATATCATCGGTA -> GGAAGCATATCATCGGTAC
ACCAAGATACGCCACCCAC -> CCAAGATACGCCACCCACA
GGTGCAGGACACACCTGCG -> GTGCAGGACACACCTGCGT
GTTTAGTACTAGCCCTCCC -> TTTAGTACTAGCCCTCCCC
ATTTTATGATTGGGAGCAA -> TTTTATGATTGGGAGCAAG
GTACCAAGTTTAGTACTAG -> TACCAAGTTTAGTACTAGC
GGCCCGCGAGTGATAAAGT -> GCCCGCGAGTGATAAAGTC
GCGGGCTGACCCACTACTT -> CGGGCTGACCCACTACTTT
ATCATCGGTACCCCCATGG -> TCATCGGTACCCCCATGGT
GGGGTCTGCATACACAGCG -> GGGTCTGCATACACAGCGT
ACACCAAGAGTACATGCGA -> CACCAAGAGTACATGCGAG
GTAAATAGTATCCGTTTGG -> TAAATAGTATCCGTTTGGT
CCTGATGCCGACGCAAATA -> CTGATGCCGACGCAAATAT
GACACACCTGCGTTGTAAG -> ACACACCTGCGTTGTAAGG
TATGTACGATAGGTAGACG -> ATGTACGATAGGTAGACGA
AAGCGTCGAACACCAAGAG -> AGCGTCGAACACCAAGAGT
AGACCGATACAGATACGCC -> GACCGATACAGATACGCCA
GTTGAATTTGGGGTCTGCA -> TTGAATTTGGGGTCTGCAT
CTCTTTGTAGCCATCACTA -> TCTTTGTAGCCATCACTAT
ACACAGCGTGCCAACCCAG -> CACAGCGTGCCAACCCAGT
GCAGGAACCGTCTAGACCC -> CAGGAACCGTCTAGACCCC
GTCTGCATACACAGCGTGG -> TCTGCATACACAGCGTGGC
ATGCCCAAATTAATCCGCG -> TGCCCAAATTAATCCGCGT
GTCTGCATACACAGCGTGC -> TCTGCATACACAGCGTGCC,TCTGCATACACAGCGTGCG
GGCACCCTTGATATAGTAG -> GCACCCTTGATATAGTAGG
GTCTGCATACACAGCGTGA -> TCTGCATACACAGCGTGAG
TACGCCACCCACAGCAAGA -> ACGCCACCCACAGCAAGAG
TAGGTGAATTGGAATAGAT -> AGGTGAATTGGAATAGATA
GCCACGACTGATTAATGGT -> CCACGACTGATTAATGGTG
ATACGCAGGAACCCGGGAC -> TACGCAGGAACCCGGGACA
GTCCATCGTGCTGATGTTG -> TCCATCGTGCTGATGTTGA
AACACTTCAGTGCTTTACC -> ACACTTCAGTGCTTTACCT
ATGCAGGAACCGTCTAGAC -> TGCAGGAACCGTCTAGACC
