GGCATCCGGAGTATGCAATA -> GCATCCGGAGTATGCAATAC
CAAGGTACGCGACTGTAAGT -> AAGGTACGCGACTGTAAGTC
ATTGCACGTGCGTTCGCCTT -> TTGCACGTGCGTTCGCCTTC
AGTCTCATGGTCGGCTGTAT -> GTCTCATGGTCGGCTGTATA
TAATCGGCTGTCCATTGTAA -> AATCGGCTGTCCATTGTAAA
TAACATAAAACCTGGCATTC -> AACATAAAACCTGGCATTCC
TGAGTCGGGTTATATTGCAC -> GAGTCGGGTTATATTGCACG
CCAACCAAGACCCCGTAACA -> CAACCAAGACCCCGTAACAT
CGGTGATTTAATCCGGTTGA -> GGTGATTTAATCCGGTTGAC
CGTGTCTACGACTGGGAGAC -> GTGTCTACGACTGGGAGACA
TCGCTGTCTAACGTCGGGAG -> CGCTGTCTAACGTCGGGAGT
CCGACTCCGACCTGTGTTAC -> CGACTCCGACCTGTGTTACA
GGTCGGCTACGCTCCCGGTG -> GTCGGCTACGCTCCCGGTGA
TCGTGAGGTGAAACAGCGCA -> CGTGAGGTGAAACAGCGCAT
AGCCGTGGCTGCGAGACGCC -> GCCGTGGCTGCGAGACGCCT
TCTAGAAACTTGGAGCCGTG -> CTAGAAACTTGGAGCCGTGG
TGTGGCTTACCAGGGAGTAT -> GTGGCTTACCAGGGAGTATC
GACACATTCTTGAGACTACG -> ACACATTCTTGAGACTACGG
GCCCAAATTGTCTAGAAACT -> CCCAAATTGTCTAGAAACTT
GTCCGATGAGAGATGGTGTG -> TCCGATGAGAGATGGTGTGG
CCGAGGACGGGTTTGAACTG -> CGAGGACGGGTTTGAACTGA
TGGAGCCGTGGCTGCGAGAC -> GGAGCCGTGGCTGCGAGACG
CTTACCAGGGAGTATCAGCA -> TTACCAGGGAGTATCAGCAT
TGTCCTAATTGTAAATATGT -> GTCCTAATTGTAAATATGTG
GCGGCTAGAGTTCGGCATTT -> CGGCTAGAGTTCGGCATTTC
ACACTTCCGCGCTCTGAGCT -> CACTTCCGCGCTCTGAGCTA
CCGGCGCGCCTCCGTCACAG -> CGGCGCGCCTCCGTCACAGG
AGAGATGGTGTGGGCCCGTG -> GAGATGGTGTGGGCCCGTGC
TTGCCCACTGCTATTGGATC -> TGCCCACTGCTATTGGATCA
GAACTGAGTCGGGTTATATT -> AACTGAGTCGGGTTATATTG
GCATTCCGAGGACGGGTTTG -> CATTCCGAGGACGGGTTTGA
AATTGTAAATATGTGACCAG -> ATTGTAAATATGTGACCAGG
CACTGCTATTGGATCAGCAG -> ACTGCTATTGGATCAGCAGC
GACGCCTGGGTCGATCGTGA -> ACGCCTGGGTCGATCGTGAG
ACACCCGGCGCGCCTCCGTC -> CACCCGGCGCGCCTCCGTCA
AAGTCTCATGGTCGGCTGTA -> AGTCTCATGGTCGGCTGTAT
GAGTGTCCTAATTGTAAATA -> AGTGTCCTAATTGTAAATAT
AGGTTGCCGATTAGGTCCGC -> GGTTGCCGATTAGGTCCGCG
CAGGTTGCCGATTAGGTCCG -> AGGTTGCCGATTAGGTCCGC
GTGTATCCGACTCCGACCTG -> TGTATCCGACTCCGACCTGT
GCTGTCTAACGTCGGGAGTT -> CTGTCTAACGTCGGGAGTTG
ATCCTGCCTATAGGCTACTT -> TCCTGCCTATAGGCTACTTT
CGCATATGAGCCTCAGAAGA -> GCATATGAGCCTCAGAAGAC
TTCACCGGCGCGGACACATT -> TCACCGGCGCGGACACATTC
ATCCGGTTGACCTTCCCCAA -> TCCGGTTGACCTTCCCCAAT
ATTTAATCCGGTTGACCTTC -> TTTAATCCGGTTGACCTTCC
GTGATTTAATCCGGTTGACC -> TGATTTAATCCGGTTGACCT
CCGTTTACGTGTATCCGACT -> CGTTTACGTGTATCCGACTC
CCAAATTGTCTAGAAACTTG -> CAAATTGTCTAGAAACTTGG
ATTGCCCAAATTGTCTAGAA -> TTGCCCAAATTGTCTAGAAA
CGCTTAAGAAGGTCCGATGA -> GCTTAAGAAGGTCCGATGAG
TGGATCAGCAGCGGCTAGAG -> GGATCAGCAGCGGCTAGAGT
AAAACCTGGCATTCCGAGGA -> AAACCTGGCATTCCGAGGAC
CGGGAGTTGATACCAACATT -> GGGAGTTGATACCAACATTT
CAGAAGACTTAATACCACTC -> AGAAGACTTAATACCACTCT
CATACGCTATCTACACGCGC -> ATACGCTATCTACACGCGCT
TCGGCTGTATAGGGGGTCTT -> CGGCTGTATAGGGGGTCTTG
AGAGTGTCCTAATTGTAAAT -> GAGTGTCCTAATTGTAAATA
TGCGCTCTTCACCGGCGCGG -> GCGCTCTTCACCGGCGCGGA
GACCCACCTGTGCGCTCTTC -> ACCCACCTGTGCGCTCTTCA
GCCTGGGTCGATCGTGAGGT -> CCTGGGTCGATCGTGAGGTG
ATAGGCTACTTTAGACATTG -> TAGGCTACTTTAGACATTGC
TACGTGTATCCGACTCCGAC -> ACGTGTATCCGACTCCGACC
GTGGGCCCGTGCGTGGTTAG -> TGGGCCCGTGCGTGGTTAGG
GGTGTGGGCCCGTGCGTGGT -> GTGTGGGCCCGTGCGTGGTT
CGCGACTGTAAGTCTCATGG -> GCGACTGTAAGTCTCATGGT
CTTCACCGGCGCGGACACAT -> TTCACCGGCGCGGACACATT
ACCTGTGCGCTCTTCACCGG -> CCTGTGCGCTCTTCACCGGC
AGACTTAATACCACTCTGGT -> GACTTAATACCACTCTGGTG
CTGATGTTGTGGCTTACCAG -> TGATGTTGTGGCTTACCAGG
AAGGTACGCGACTGTAAGTC -> AGGTACGCGACTGTAAGTCT
CCTGACCCTTCACTGCGTAT -> CTGACCCTTCACTGCGTATC
CAAATTGTCTAGAAACTTGG -> AAATTGTCTAGAAACTTGGA
ACCTGTGTTACACTGCGCTG -> CCTGTGTTACACTGCGCTGT
GTTTGAACTGAGTCGGGTTA -> TTTGAACTGAGTCGGGTTAT
GTTGGAGTGATACACACTTC -> TTGGAGTGATACACACTTCC
TAAGAAGGTCCGATGAGAGA -> AAGAAGGTCCGATGAGAGAT
GCTATCTACACGCGCTGGGG -> CTATCTACACGCGCTGGGGC
TCCGATGAGAGATGGTGTGG -> CCGATGAGAGATGGTGTGGG
GGTGATTTAATCCGGTTGAC -> GTGATTTAATCCGGTTGACC
AAACTTGGAGCCGTGGCTGC -> AACTTGGAGCCGTGGCTGCG
TTCCGAGGACGGGTTTGAAC -> TCCGAGGACGGGTTTGAACT
GCTACGCTCCCGGTGATTTA -> CTACGCTCCCGGTGATTTAA
TGGCATTCCGAGGACGGGTT -> GGCATTCCGAGGACGGGTTT
AAACAGCGCATACGCTATCT -> AACAGCGCATACGCTATCTA
AACATTTACTATAATCGGCT -> ACATTTACTATAATCGGCTG
TACGGGGTCTGGATAATACC -> ACGGGGTCTGGATAATACCT
CTCATGGTCGGCTGTATAGG -> TCATGGTCGGCTGTATAGGG
CGGGACTGACCCACCTGTGC -> GGGACTGACCCACCTGTGCG
TGGGAGACACGAGCCTGACC -> GGGAGACACGAGCCTGACCC
TATCCTGCCTATAGGCTACT -> ATCCTGCCTATAGGCTACTT
TTAGACATTGCCCAAATTGT -> TAGACATTGCCCAAATTGTC
GTCGGCTGTATAGGGGGTCT -> TCGGCTGTATAGGGGGTCTT
ATACCAACATTTACTATAAT -> TACCAACATTTACTATAATC
GAGTATGCAATACCGTTTAC -> AGTATGCAATACCGTTTACG
GTGGCTGCGAGACGCCTGGG -> TGGCTGCGAGACGCCTGGGT
GTAAAAACGAGGCATGGACA -> TAAAAACGAGGCATGGACAC
TGCGAGACGCCTGGGTCGAT -> GCGAGACGCCTGGGTCGATC
GACATTGCCCAAATTGTCTA -> ACATTGCCCAAATTGTCTAG
TATAACTTCCAAGTTGACAC -> ATAACTTCCAAGTTGACACA
TATATTGCACGTGCGTTCGC -> ATATTGCACGTGCGTTCGCC
CTTGCCCACTGCTATTGGAT -> TTGCCCACTGCTATTGGATC
TGCGTGGTTAGGCCGTGTCG -> GCGTGGTTAGGCCGTGTCGG
GATGAGAGATGGTGTGGGCC -> ATGAGAGATGGTGTGGGCCC
CCCGTAACATGTGCTGATGT -> CCGTAACATGTGCTGATGTT
TAGAGTTCGGCATTTCGCCA -> AGAGTTCGGCATTTCGCCAT
TAACTTCCAAGTTGACACAG -> AACTTCCAAGTTGACACAGA
AAGGTCCGATGAGAGATGGT -> AGGTCCGATGAGAGATGGTG
TTTGAACTGAGTCGGGTTAT -> TTGAACTGAGTCGGGTTATA
CATTTCGCCATCACCACGAG -> ATTTCGCCATCACCACGAGT
CGCTGTTGGAGTGATACACA -> GCTGTTGGAGTGATACACAC
GTCTCATGGTCGGCTGTATA -> TCTCATGGTCGGCTGTATAG
TCGCCATCACCACGAGTTCT -> CGCCATCACCACGAGTTCTC
GCAAGGTACGCGACTGTAAG -> CAAGGTACGCGACTGTAAGT
GCGACTGTAAGTCTCATGGT -> CGACTGTAAGTCTCATGGTC
TGCAAGGTACGCGACTGTAA -> GCAAGGTACGCGACTGTAAG
GCGTGTCTACGACTGGGAGA -> CGTGTCTACGACTGGGAGAC
CGACCTGTGTTACACTGCGC -> GACCTGTGTTACACTGCGCT
CAGCAGCGGCTAGAGTTCGG -> AGCAGCGGCTAGAGTTCGGC
GTGATACACACTTCCGCGCT -> TGATACACACTTCCGCGCTC
TACCACTCTGGTGCGTGTCT -> ACCACTCTGGTGCGTGTCTA
ATTGTTGTTAAATTTAGCAC -> TTGTTGTTAAATTTAGCACA
GAGCTTCGGTCTGAGCGCTT -> AGCTTCGGTCTGAGCGCTTA
AGGGGGTCTTGCCCACTGCT -> GGGGGTCTTGCCCACTGCTA
GACCTTCCCCAATCTAGGCA -> ACCTTCCCCAATCTAGGCAG
AGCATACCTCGGCCTCTGGA -> GCATACCTCGGCCTCTGGAA
GTACGCGACTGTAAGTCTCA -> TACGCGACTGTAAGTCTCAT
ATTCCGAGGACGGGTTTGAA -> TTCCGAGGACGGGTTTGAAC
GGCCAAGAAGACCAACCAAG -> GCCAAGAAGACCAACCAAGA
TTGATACCAACATTTACTAT -> TGATACCAACATTTACTATA
GTCGATCGTGAGGTGAAACA -> TCGATCGTGAGGTGAAACAG
AATACCTGAGTGAATGGACC -> ATACCTGAGTGAATGGACCG
TGACACAGATGCACTGCAAG -> GACACAGATGCACTGCAAGG
GTGCGTGGTTAGGCCGTGTC -> TGCGTGGTTAGGCCGTGTCG
CACGCGCTGGGGCATCCGGA -> ACGCGCTGGGGCATCCGGAG
GGGTTTGAACTGAGTCGGGT -> GGTTTGAACTGAGTCGGGTT
AGGTCGGCTACGCTCCCGGT -> GGTCGGCTACGCTCCCGGTG
ACGTGTATCCGACTCCGACC -> CGTGTATCCGACTCCGACCT
GGTCTGGATAATACCTGAGT -> GTCTGGATAATACCTGAGTG
TTAATCCGGTTGACCTTCCC -> TAATCCGGTTGACCTTCCCC
TCAGCATCAGGTCGGCTACG -> CAGCATCAGGTCGGCTACGC
TCTGGAATTGTTGTTAAATT -> CTGGAATTGTTGTTAAATTT
ACATTTACTATAATCGGCTG -> CATTTACTATAATCGGCTGT
GATGGTGTGGGCCCGTGCGT -> ATGGTGTGGGCCCGTGCGTG
TTATATTGCACGTGCGTTCG -> TATATTGCACGTGCGTTCGC
TGTCGGGCCAAGAAGACCAA -> GTCGGGCCAAGAAGACCAAC
AACATAAAACCTGGCATTCC -> ACATAAAACCTGGCATTCCG
CCCACTGCTATTGGATCAGC -> CCACTGCTATTGGATCAGCA
TAGGCCGTGTCGGGCCAAGA -> AGGCCGTGTCGGGCCAAGAA
CTGCCTATAGGCTACTTTAG -> TGCCTATAGGCTACTTTAGA
TGGAATTGTTGTTAAATTTA -> GGAATTGTTGTTAAATTTAG
ACGAGCCTGACCCTTCACTG -> CGAGCCTGACCCTTCACTGC
GGCTAGAGTTCGGCATTTCG -> GCTAGAGTTCGGCATTTCGC
GAGCCTCAGAAGACTTAATA -> AGCCTCAGAAGACTTAATAC
ATTAGGTCCGCGTCAGCATC -> TTAGGTCCGCGTCAGCATCA
CTAGAGTTCGGCATTTCGCC -> TAGAGTTCGGCATTTCGCCA
CTTCCAAGTTGACACAGATG -> TTCCAAGTTGACACAGATGC
TGTCTACGACTGGGAGACAC -> GTCTACGACTGGGAGACACG
AGACACGAGCCTGACCCTTC -> GACACGAGCCTGACCCTTCA
GGGCCCGTGCGTGGTTAGGC -> GGCCCGTGCGTGGTTAGGCC
TTAGCACAGAGTGTCCTAAT -> TAGCACAGAGTGTCCTAATT
CGGCTGTCCATTGTAAAAAC -> GGCTGTCCATTGTAAAAACG
GGTCGATCGTGAGGTGAAAC -> GTCGATCGTGAGGTGAAACA
GTCTGAGCGCTTAAGAAGGT -> TCTGAGCGCTTAAGAAGGTC
TAATCCGGTTGACCTTCCCC -> AATCCGGTTGACCTTCCCCA
GAAGGTCCGATGAGAGATGG -> AAGGTCCGATGAGAGATGGT
CTCTTCACCGGCGCGGACAC -> TCTTCACCGGCGCGGACACA
TGAGAGATGGTGTGGGCCCG -> GAGAGATGGTGTGGGCCCGT
GTTACACTGCGCTGTTGGAG -> TTACACTGCGCTGTTGGAGT
GCGCTGTTGGAGTGATACAC -> CGCTGTTGGAGTGATACACA
GTTGTGGCTTACCAGGGAGT -> TTGTGGCTTACCAGGGAGTA
ACGTCGGGAGTTGATACCAA -> CGTCGGGAGTTGATACCAAC
CATATGAGCCTCAGAAGACT -> ATATGAGCCTCAGAAGACTT
TACCAGGGAGTATCAGCATA -> ACCAGGGAGTATCAGCATAC
TTGCCCAAATTGTCTAGAAA -> TGCCCAAATTGTCTAGAAAC
TCAGCATACCTCGGCCTCTG -> CAGCATACCTCGGCCTCTGG
AACAGCGCATACGCTATCTA -> ACAGCGCATACGCTATCTAC
GGGTTATATTGCACGTGCGT -> GGTTATATTGCACGTGCGTT
GAGTCGGGTTATATTGCACG -> AGTCGGGTTATATTGCACGT
CTAGGCAGTATATAACTTCC -> TAGGCAGTATATAACTTCCA
CCGCGTCAGCATCAGGTCGG -> CGCGTCAGCATCAGGTCGGC
GATAATACCTGAGTGAATGG -> ATAATACCTGAGTGAATGGA
TTAGGCCGTGTCGGGCCAAG -> TAGGCCGTGTCGGGCCAAGA
CCGACCTGTGTTACACTGCG -> CGACCTGTGTTACACTGCGC
TCCTAATTGTAAATATGTGA -> CCTAATTGTAAATATGTGAC
CGATCGTGAGGTGAAACAGC -> GATCGTGAGGTGAAACAGCG
AAGAAGACCAACCAAGACCC -> AGAAGACCAACCAAGACCCC
TGAGTGAATGGACCGTTCAA -> GAGTGAATGGACCGTTCAAT
GAAGACCAACCAAGACCCCG -> AAGACCAACCAAGACCCCGT
TCTCTCCATCTTAACATAAA -> CTCTCCATCTTAACATAAAA
CGATGAGAGATGGTGTGGGC -> GATGAGAGATGGTGTGGGCC
CTGTGTTACACTGCGCTGTT -> TGTGTTACACTGCGCTGTTG
GCTACTTTAGACATTGCCCA -> CTACTTTAGACATTGCCCAA
CTGTCCATTGTAAAAACGAG -> TGTCCATTGTAAAAACGAGG
TGGTGCGTGTCTACGACTGG -> GGTGCGTGTCTACGACTGGG
TCTGGTGCGTGTCTACGACT -> CTGGTGCGTGTCTACGACTG
CCGTGCGTGGTTAGGCCGTG -> CGTGCGTGGTTAGGCCGTGT
TCGGCATTTCGCCATCACCA -> CGGCATTTCGCCATCACCAC
ATCTTAACATAAAACCTGGC -> TCTTAACATAAAACCTGGCA
GAGCGCTTAAGAAGGTCCGA -> AGCGCTTAAGAAGGTCCGAT
GACTTAATACCACTCTGGTG -> ACTTAATACCACTCTGGTGC
ACTTCCAAGTTGACACAGAT -> CTTCCAAGTTGACACAGATG
GCTGATGTTGTGGCTTACCA -> CTGATGTTGTGGCTTACCAG
TGACCCACCTGTGCGCTCTT -> GACCCACCTGTGCGCTCTTC
AAATTGTCTAGAAACTTGGA -> AATTGTCTAGAAACTTGGAG
CCAAGTTGACACAGATGCAC -> CAAGTTGACACAGATGCACT
CACACTTCCGCGCTCTGAGC -> ACACTTCCGCGCTCTGAGCT
CCACTGCTATTGGATCAGCA -> CACTGCTATTGGATCAGCAG
CTGTTGGAGTGATACACACT -> TGTTGGAGTGATACACACTT
ATCCGACTCCGACCTGTGTT -> TCCGACTCCGACCTGTGTTA
AGACTACGGGGTCTGGATAA -> GACTACGGGGTCTGGATAAT
TCCAAGTTGACACAGATGCA -> CCAAGTTGACACAGATGCAC
GCGCGGACACATTCTTGAGA -> CGCGGACACATTCTTGAGAC
CTTGGAGCCGTGGCTGCGAG -> TTGGAGCCGTGGCTGCGAGA
GGCGCGCCTCCGTCACAGGA -> GCGCGCCTCCGTCACAGGAG
GCATCAGGTCGGCTACGCTC -> CATCAGGTCGGCTACGCTCC
ACCTTCCCCAATCTAGGCAG -> CCTTCCCCAATCTAGGCAGT
CTTCCGCGCTCTGAGCTACC -> TTCCGCGCTCTGAGCTACCT
AGACGCCTGGGTCGATCGTG -> GACGCCTGGGTCGATCGTGA
GTCTTGCCCACTGCTATTGG -> TCTTGCCCACTGCTATTGGA
CGAGGACGGGTTTGAACTGA -> GAGGACGGGTTTGAACTGAG
ATTGTAAAAACGAGGCATGG -> TTGTAAAAACGAGGCATGGA
TGTGACCAGGTTGCCGATTA -> GTGACCAGGTTGCCGATTAG
ATTGTAAATATGTGACCAGG -> TTGTAAATATGTGACCAGGT
CCTGGCATTCCGAGGACGGG -> CTGGCATTCCGAGGACGGGT
CGAGTTCTCTCCATCTTAAC -> GAGTTCTCTCCATCTTAACA
GCTGTATAGGGGGTCTTGCC -> CTGTATAGGGGGTCTTGCCC
TGTGGGCCCGTGCGTGGTTA -> GTGGGCCCGTGCGTGGTTAG
GACACGAGCCTGACCCTTCA -> ACACGAGCCTGACCCTTCAC
GACCTGTGTTACACTGCGCT -> ACCTGTGTTACACTGCGCTG
CTGGCATTCCGAGGACGGGT -> TGGCATTCCGAGGACGGGTT
AACGAGGCATGGACACCCGG -> ACGAGGCATGGACACCCGGC
GCTGCGAGACGCCTGGGTCG -> CTGCGAGACGCCTGGGTCGA
TGTAAGTCTCATGGTCGGCT -> GTAAGTCTCATGGTCGGCTG
CATTGCCCAAATTGTCTAGA -> ATTGCCCAAATTGTCTAGAA
CTGGGGCATCCGGAGTATGC -> TGGGGCATCCGGAGTATGCA
ATTTACTATAATCGGCTGTC -> TTTACTATAATCGGCTGTCC
GTTCGGCATTTCGCCATCAC -> TTCGGCATTTCGCCATCACC
TTCGGTCTGAGCGCTTAAGA -> TCGGTCTGAGCGCTTAAGAA
CTATCTACACGCGCTGGGGC -> TATCTACACGCGCTGGGGCA
GCATCCGGAGTATGCAATAC -> CATCCGGAGTATGCAATACC
ATGGTCGGCTGTATAGGGGG -> TGGTCGGCTGTATAGGGGGT
TTACACTGCGCTGTTGGAGT -> TACACTGCGCTGTTGGAGTG
TGGGCCCGTGCGTGGTTAGG -> GGGCCCGTGCGTGGTTAGGC
GGACACCCGGCGCGCCTCCG -> GACACCCGGCGCGCCTCCGT
TCCGCGCTCTGAGCTACCTC -> CCGCGCTCTGAGCTACCTCG
CTTAAGAAGGTCCGATGAGA -> TTAAGAAGGTCCGATGAGAG
TGGGTCGATCGTGAGGTGAA -> GGGTCGATCGTGAGGTGAAA
GCTATTGGATCAGCAGCGGC -> CTATTGGATCAGCAGCGGCT
CATGTGCTGATGTTGTGGCT -> ATGTGCTGATGTTGTGGCTT
TCACCGGCGCGGACACATTC -> CACCGGCGCGGACACATTCT
GCCGTGGCTGCGAGACGCCT -> CCGTGGCTGCGAGACGCCTG
GGGAGTTGATACCAACATTT -> GGAGTTGATACCAACATTTA
GCGTTCGCCTTCGGGACTGA -> CGTTCGCCTTCGGGACTGAC
TTGCCGATTAGGTCCGCGTC -> TGCCGATTAGGTCCGCGTCA
GTTGTTAAATTTAGCACAGA -> TTGTTAAATTTAGCACAGAG
TTGAACTGAGTCGGGTTATA -> TGAACTGAGTCGGGTTATAT
AGCTTCGGTCTGAGCGCTTA -> GCTTCGGTCTGAGCGCTTAA
CCGGTGATTTAATCCGGTTG -> CGGTGATTTAATCCGGTTGA
GAGGACGGGTTTGAACTGAG -> AGGACGGGTTTGAACTGAGT
ACGCTATCTACACGCGCTGG -> CGCTATCTACACGCGCTGGG
ACTTCCGCGCTCTGAGCTAC -> CTTCCGCGCTCTGAGCTACC
TCAGGTCGGCTACGCTCCCG -> CAGGTCGGCTACGCTCCCGG
TGCGTTCGCCTTCGGGACTG -> GCGTTCGCCTTCGGGACTGA
GAATTGTTGTTAAATTTAGC -> AATTGTTGTTAAATTTAGCA
CCAGGGAGTATCAGCATACC -> CAGGGAGTATCAGCATACCT
CCTCAGAAGACTTAATACCA -> CTCAGAAGACTTAATACCAC
CACTTCCGCGCTCTGAGCTA -> ACTTCCGCGCTCTGAGCTAC
GGAATTGTTGTTAAATTTAG -> GAATTGTTGTTAAATTTAGC
TCCGACCTGTGTTACACTGC -> CCGACCTGTGTTACACTGCG
GCGTGGTTAGGCCGTGTCGG -> CGTGGTTAGGCCGTGTCGGG
CTACGCTCCCGGTGATTTAA -> TACGCTCCCGGTGATTTAAT
CTGCTATTGGATCAGCAGCG -> TGCTATTGGATCAGCAGCGG
CAGAGTGTCCTAATTGTAAA -> AGAGTGTCCTAATTGTAAAT
ACCCACCTGTGCGCTCTTCA -> CCCACCTGTGCGCTCTTCAC
CTCTGGTGCGTGTCTACGAC -> TCTGGTGCGTGTCTACGACT
CCCGGCGCGCCTCCGTCACA -> CCGGCGCGCCTCCGTCACAG
CGTAACATGTGCTGATGTTG -> GTAACATGTGCTGATGTTGT
AGCCTGACCCTTCACTGCGT -> GCCTGACCCTTCACTGCGTA
GTCCTAATTGTAAATATGTG -> TCCTAATTGTAAATATGTGA
TGAAACAGCGCATACGCTAT -> GAAACAGCGCATACGCTATC
TCTCCATCTTAACATAAAAC -> CTCCATCTTAACATAAAACC
TCGGGAGTTGATACCAACAT -> CGGGAGTTGATACCAACATT
GCCCACTGCTATTGGATCAG -> CCCACTGCTATTGGATCAGC
CCTGCCTATAGGCTACTTTA -> CTGCCTATAGGCTACTTTAG
GAGGCATGGACACCCGGCGC -> AGGCATGGACACCCGGCGCG
GCGCTCTGAGCTACCTCGCT -> CGCTCTGAGCTACCTCGCTG
ATGGTGTGGGCCCGTGCGTG -> TGGTGTGGGCCCGTGCGTGG
TGGAGTGATACACACTTCCG -> GGAGTGATACACACTTCCGC
GTGCTGATGTTGTGGCTTAC -> TGCTGATGTTGTGGCTTACC
GGTTATATTGCACGTGCGTT -> GTTATATTGCACGTGCGTTC
GTTATATTGCACGTGCGTTC -> TTATATTGCACGTGCGTTCG
CTGGTGCGTGTCTACGACTG -> TGGTGCGTGTCTACGACTGG
GCATACCTCGGCCTCTGGAA -> CATACCTCGGCCTCTGGAAT
TCGGCTGTCCATTGTAAAAA -> CGGCTGTCCATTGTAAAAAC
CGGCTAGAGTTCGGCATTTC -> GGCTAGAGTTCGGCATTTCG
TACCAACATTTACTATAATC -> ACCAACATTTACTATAATCG
ATAACTTCCAAGTTGACACA -> TAACTTCCAAGTTGACACAG
CTACACGCGCTGGGGCATCC -> TACACGCGCTGGGGCATCCG
AACCTGGCATTCCGAGGACG -> ACCTGGCATTCCGAGGACGG
GCACAGAGTGTCCTAATTGT -> CACAGAGTGTCCTAATTGTA
GAGACTACGGGGTCTGGATA -> AGACTACGGGGTCTGGATAA
GTCGGGTTATATTGCACGTG -> TCGGGTTATATTGCACGTGC
CTAACGTCGGGAGTTGATAC -> TAACGTCGGGAGTTGATACC
CGCGTCAGCATCAGGTCGGC -> GCGTCAGCATCAGGTCGGCT
GAAACAGCGCATACGCTATC -> AAACAGCGCATACGCTATCT
TTACCAGGGAGTATCAGCAT -> TACCAGGGAGTATCAGCATA
CCTAATTGTAAATATGTGAC -> CTAATTGTAAATATGTGACC
TTGTTGTTAAATTTAGCACA -> TGTTGTTAAATTTAGCACAG
GATGTTGTGGCTTACCAGGG -> ATGTTGTGGCTTACCAGGGA
CGGGGTCTGGATAATACCTG -> GGGGTCTGGATAATACCTGA
GGGCATCCGGAGTATGCAAT -> GGCATCCGGAGTATGCAATA
ACTGGGAGACACGAGCCTGA -> CTGGGAGACACGAGCCTGAC
TGTCCATTGTAAAAACGAGG -> GTCCATTGTAAAAACGAGGC
CCTGTGCGCTCTTCACCGGC -> CTGTGCGCTCTTCACCGGCG
CTACGACTGGGAGACACGAG -> TACGACTGGGAGACACGAGC
ACTCTGGTGCGTGTCTACGA -> CTCTGGTGCGTGTCTACGAC
ACGCGACTGTAAGTCTCATG -> CGCGACTGTAAGTCTCATGG
CGGCATTTCGCCATCACCAC -> GGCATTTCGCCATCACCACG
CTTCGGTCTGAGCGCTTAAG -> TTCGGTCTGAGCGCTTAAGA
CTTAATACCACTCTGGTGCG -> TTAATACCACTCTGGTGCGT
ATAATCGGCTGTCCATTGTA -> TAATCGGCTGTCCATTGTAA
GCCAAGAAGACCAACCAAGA -> CCAAGAAGACCAACCAAGAC
GGGACTGACCCACCTGTGCG -> GGACTGACCCACCTGTGCGC
GAGTGATACACACTTCCGCG -> AGTGATACACACTTCCGCGC
GCATTTCGCCATCACCACGA -> CATTTCGCCATCACCACGAG
TGTATCCGACTCCGACCTGT -> GTATCCGACTCCGACCTGTG
CTGACCCACCTGTGCGCTCT -> TGACCCACCTGTGCGCTCTT
CTGAGCTACCTCGCTGTCTA -> TGAGCTACCTCGCTGTCTAA
AGAAGGTCCGATGAGAGATG -> GAAGGTCCGATGAGAGATGG
GCGCTGGGGCATCCGGAGTA -> CGCTGGGGCATCCGGAGTAT
TGCTATTGGATCAGCAGCGG -> GCTATTGGATCAGCAGCGGC
ATGGACACCCGGCGCGCCTC -> TGGACACCCGGCGCGCCTCC
AGAGTTCGGCATTTCGCCAT -> GAGTTCGGCATTTCGCCATC
CCGCATATGAGCCTCAGAAG -> CGCATATGAGCCTCAGAAGA
GCTGGGGCATCCGGAGTATG -> CTGGGGCATCCGGAGTATGC
GCGAGACGCCTGGGTCGATC -> CGAGACGCCTGGGTCGATCG
TACACTGCGCTGTTGGAGTG -> ACACTGCGCTGTTGGAGTGA
TACACGCGCTGGGGCATCCG -> ACACGCGCTGGGGCATCCGG
TTAAATTTAGCACAGAGTGT -> TAAATTTAGCACAGAGTGTC
TTGTGGCTTACCAGGGAGTA -> TGTGGCTTACCAGGGAGTAT
ATTGTCTAGAAACTTGGAGC -> TTGTCTAGAAACTTGGAGCC
CTCCGACCTGTGTTACACTG -> TCCGACCTGTGTTACACTGC
ACTGCGTATCCTGCCTATAG -> CTGCGTATCCTGCCTATAGG
CCAAGACCCCGTAACATGTG -> CAAGACCCCGTAACATGTGC
CTGGGTCGATCGTGAGGTGA -> TGGGTCGATCGTGAGGTGAA
GGCCCGTGCGTGGTTAGGCC -> GCCCGTGCGTGGTTAGGCCG
GGCTACGCTCCCGGTGATTT -> GCTACGCTCCCGGTGATTTA
CGGAGTATGCAATACCGTTT -> GGAGTATGCAATACCGTTTA
CCGGCGCGGACACATTCTTG -> CGGCGCGGACACATTCTTGA
TATAGGCTACTTTAGACATT -> ATAGGCTACTTTAGACATTG
TCCATTGTAAAAACGAGGCA -> CCATTGTAAAAACGAGGCAT
TGTTGTTAAATTTAGCACAG -> GTTGTTAAATTTAGCACAGA
CGGGTTTGAACTGAGTCGGG -> GGGTTTGAACTGAGTCGGGT
ACGGGGTCTGGATAATACCT -> CGGGGTCTGGATAATACCTG
TTCGCCTTCGGGACTGACCC -> TCGCCTTCGGGACTGACCCA
ACATGTGCTGATGTTGTGGC -> CATGTGCTGATGTTGTGGCT
CACTGCGCTGTTGGAGTGAT -> ACTGCGCTGTTGGAGTGATA
ACAGGAGCTTCGGTCTGAGC -> CAGGAGCTTCGGTCTGAGCG
TCCGACTCCGACCTGTGTTA -> CCGACTCCGACCTGTGTTAC
ATTTCGCCATCACCACGAGT -> TTTCGCCATCACCACGAGTT
CAATCTAGGCAGTATATAAC -> AATCTAGGCAGTATATAACT
GAGTTCTCTCCATCTTAACA -> AGTTCTCTCCATCTTAACAT
GGATCAGCAGCGGCTAGAGT -> GATCAGCAGCGGCTAGAGTT
CCCAAATTGTCTAGAAACTT -> CCAAATTGTCTAGAAACTTG
CAGCATCAGGTCGGCTACGC -> AGCATCAGGTCGGCTACGCT
GACCAGGTTGCCGATTAGGT -> ACCAGGTTGCCGATTAGGTC
GAGACACGAGCCTGACCCTT -> AGACACGAGCCTGACCCTTC
TGGACACCCGGCGCGCCTCC -> GGACACCCGGCGCGCCTCCG
GGAGTTGATACCAACATTTA -> GAGTTGATACCAACATTTAC
ACCACTCTGGTGCGTGTCTA -> CCACTCTGGTGCGTGTCTAC
TTGTTAAATTTAGCACAGAG -> TGTTAAATTTAGCACAGAGT
AGTATCAGCATACCTCGGCC -> GTATCAGCATACCTCGGCCT
TGTTACACTGCGCTGTTGGA -> GTTACACTGCGCTGTTGGAG
AAGACCAACCAAGACCCCGT -> AGACCAACCAAGACCCCGTA
GAAGACTTAATACCACTCTG -> AAGACTTAATACCACTCTGG
TCTTGAGACTACGGGGTCTG -> CTTGAGACTACGGGGTCTGG
GCCTATAGGCTACTTTAGAC -> CCTATAGGCTACTTTAGACA
TGGGGCATCCGGAGTATGCA -> GGGGCATCCGGAGTATGCAA
CCCCGTAACATGTGCTGATG -> CCCGTAACATGTGCTGATGT
AGCGCATACGCTATCTACAC -> GCGCATACGCTATCTACACG
TCCGCATATGAGCCTCAGAA -> CCGCATATGAGCCTCAGAAG
GCCCGTGCGTGGTTAGGCCG -> CCCGTGCGTGGTTAGGCCGT
ACCAAGACCCCGTAACATGT -> CCAAGACCCCGTAACATGTG
TTGTCTAGAAACTTGGAGCC -> TGTCTAGAAACTTGGAGCCG
TGATTTAATCCGGTTGACCT -> GATTTAATCCGGTTGACCTT
TGGTTAGGCCGTGTCGGGCC -> GGTTAGGCCGTGTCGGGCCA
CGCCTCCGTCACAGGAGCTT -> GCCTCCGTCACAGGAGCTTC
TAGACATTGCCCAAATTGTC -> AGACATTGCCCAAATTGTCT
ATCACCACGAGTTCTCTCCA -> TCACCACGAGTTCTCTCCAT
CTCAGAAGACTTAATACCAC -> TCAGAAGACTTAATACCACT
TCCGGTTGACCTTCCCCAAT -> CCGGTTGACCTTCCCCAATC
TCGCCTTCGGGACTGACCCA -> CGCCTTCGGGACTGACCCAC
ACCACGAGTTCTCTCCATCT -> CCACGAGTTCTCTCCATCTT
CACGAGCCTGACCCTTCACT -> ACGAGCCTGACCCTTCACTG
GTCCGCATATGAGCCTCAGA -> TCCGCATATGAGCCTCAGAA
ACTGCAAGGTACGCGACTGT -> CTGCAAGGTACGCGACTGTA
TGAGCGCTTAAGAAGGTCCG -> GAGCGCTTAAGAAGGTCCGA
CGCTCTGAGCTACCTCGCTG -> GCTCTGAGCTACCTCGCTGT
TCTAACGTCGGGAGTTGATA -> CTAACGTCGGGAGTTGATAC
TCCGGAGTATGCAATACCGT -> CCGGAGTATGCAATACCGTT
ACCTGAGTGAATGGACCGTT -> CCTGAGTGAATGGACCGTTC
GCAGCGGCTAGAGTTCGGCA -> CAGCGGCTAGAGTTCGGCAT
CGTCACAGGAGCTTCGGTCT -> GTCACAGGAGCTTCGGTCTG
TAAATTTAGCACAGAGTGTC -> AAATTTAGCACAGAGTGTCC
TCGATCGTGAGGTGAAACAG -> CGATCGTGAGGTGAAACAGC
TAATACCACTCTGGTGCGTG -> AATACCACTCTGGTGCGTGT
GCTCTGAGCTACCTCGCTGT -> CTCTGAGCTACCTCGCTGTC
TTGTAAAAACGAGGCATGGA -> TGTAAAAACGAGGCATGGAC
ACCTCGGCCTCTGGAATTGT -> CCTCGGCCTCTGGAATTGTT
GACACAGATGCACTGCAAGG -> ACACAGATGCACTGCAAGGT
CAAGACCCCGTAACATGTGC -> AAGACCCCGTAACATGTGCT
GCTAGAGTTCGGCATTTCGC -> CTAGAGTTCGGCATTTCGCC
TGACCTTCCCCAATCTAGGC -> GACCTTCCCCAATCTAGGCA
CGGCTACGCTCCCGGTGATT -> GGCTACGCTCCCGGTGATTT
CTCCCGGTGATTTAATCCGG -> TCCCGGTGATTTAATCCGGT
ACCAGGTTGCCGATTAGGTC -> CCAGGTTGCCGATTAGGTCC
TGATACCAACATTTACTATA -> GATACCAACATTTACTATAA
CAACCAAGACCCCGTAACAT -> AACCAAGACCCCGTAACATG
TGTGCTGATGTTGTGGCTTA -> GTGCTGATGTTGTGGCTTAC
GGTCCGATGAGAGATGGTGT -> GTCCGATGAGAGATGGTGTG
GTGAGGTGAAACAGCGCATA -> TGAGGTGAAACAGCGCATAC
CCTGAGTGAATGGACCGTTC -> CTGAGTGAATGGACCGTTCA
ACCTGGCATTCCGAGGACGG -> CCTGGCATTCCGAGGACGGG
CATTTACTATAATCGGCTGT -> ATTTACTATAATCGGCTGTC
TGATGTTGTGGCTTACCAGG -> GATGTTGTGGCTTACCAGGG
GAAACTTGGAGCCGTGGCTG -> AAACTTGGAGCCGTGGCTGC
GACTGACCCACCTGTGCGCT -> ACTGACCCACCTGTGCGCTC
ACCAACATTTACTATAATCG -> CCAACATTTACTATAATCGG
AGACATTGCCCAAATTGTCT -> GACATTGCCCAAATTGTCTA
TACGCGACTGTAAGTCTCAT -> ACGCGACTGTAAGTCTCATG
GCTTCGGTCTGAGCGCTTAA -> CTTCGGTCTGAGCGCTTAAG
CTGCGAGACGCCTGGGTCGA -> TGCGAGACGCCTGGGTCGAT
CGCTATCTACACGCGCTGGG -> GCTATCTACACGCGCTGGGG
GTTGATACCAACATTTACTA -> TTGATACCAACATTTACTAT
CCACCTGTGCGCTCTTCACC -> CACCTGTGCGCTCTTCACCG
ATCCGGAGTATGCAATACCG -> TCCGGAGTATGCAATACCGT
GGAGTATCAGCATACCTCGG -> GAGTATCAGCATACCTCGGC
TCTGAGCGCTTAAGAAGGTC -> CTGAGCGCTTAAGAAGGTCC
ATATGTGACCAGGTTGCCGA -> TATGTGACCAGGTTGCCGAT
ACTGACCCACCTGTGCGCTC -> CTGACCCACCTGTGCGCTCT
TACGACTGGGAGACACGAGC -> ACGACTGGGAGACACGAGCC
CACTGCGTATCCTGCCTATA -> ACTGCGTATCCTGCCTATAG
TGTGCGCTCTTCACCGGCGC -> GTGCGCTCTTCACCGGCGCG
CATCACCACGAGTTCTCTCC -> ATCACCACGAGTTCTCTCCA
TAACATGTGCTGATGTTGTG -> AACATGTGCTGATGTTGTGG
AGAAACTTGGAGCCGTGGCT -> GAAACTTGGAGCCGTGGCTG
CCATTGTAAAAACGAGGCAT -> CATTGTAAAAACGAGGCATG
AAAACGAGGCATGGACACCC -> AAACGAGGCATGGACACCCG
TCGGCTACGCTCCCGGTGAT -> CGGCTACGCTCCCGGTGATT
CTATTGGATCAGCAGCGGCT -> TATTGGATCAGCAGCGGCTA
GGCTACTTTAGACATTGCCC -> GCTACTTTAGACATTGCCCA
GTGTTACACTGCGCTGTTGG -> TGTTACACTGCGCTGTTGGA
CAATACCGTTTACGTGTATC -> AATACCGTTTACGTGTATCC
TTGGAGTGATACACACTTCC -> TGGAGTGATACACACTTCCG
ATGCACTGCAAGGTACGCGA -> TGCACTGCAAGGTACGCGAC
CCTATAGGCTACTTTAGACA -> CTATAGGCTACTTTAGACAT
GCGCGCCTCCGTCACAGGAG -> CGCGCCTCCGTCACAGGAGC
GGTTGCCGATTAGGTCCGCG -> GTTGCCGATTAGGTCCGCGT
CCGATGAGAGATGGTGTGGG -> CGATGAGAGATGGTGTGGGC
TGTAAATATGTGACCAGGTT -> GTAAATATGTGACCAGGTTG
GGTCGGCTGTATAGGGGGTC -> GTCGGCTGTATAGGGGGTCT
AGCGCTTAAGAAGGTCCGAT -> GCGCTTAAGAAGGTCCGATG
AGACCAACCAAGACCCCGTA -> GACCAACCAAGACCCCGTAA
AATTTAGCACAGAGTGTCCT -> ATTTAGCACAGAGTGTCCTA
CAAGTTGACACAGATGCACT -> AAGTTGACACAGATGCACTG
AGATGGTGTGGGCCCGTGCG -> GATGGTGTGGGCCCGTGCGT
GTATAGGGGGTCTTGCCCAC -> TATAGGGGGTCTTGCCCACT
TTTAATCCGGTTGACCTTCC -> TTAATCCGGTTGACCTTCCC
GCGTCAGCATCAGGTCGGCT -> CGTCAGCATCAGGTCGGCTA
CGTGGTTAGGCCGTGTCGGG -> GTGGTTAGGCCGTGTCGGGC
CCGCGCTCTGAGCTACCTCG -> CGCGCTCTGAGCTACCTCGC
GGCAGTATATAACTTCCAAG -> GCAGTATATAACTTCCAAGT
CTGAGTCGGGTTATATTGCA -> TGAGTCGGGTTATATTGCAC
TCTTGCCCACTGCTATTGGA -> CTTGCCCACTGCTATTGGAT
GACTCCGACCTGTGTTACAC -> ACTCCGACCTGTGTTACACT
TATTGGATCAGCAGCGGCTA -> ATTGGATCAGCAGCGGCTAG
ACGACTGGGAGACACGAGCC -> CGACTGGGAGACACGAGCCT
AAACCTGGCATTCCGAGGAC -> AACCTGGCATTCCGAGGACG
CCAATCTAGGCAGTATATAA -> CAATCTAGGCAGTATATAAC
GGCTGTCCATTGTAAAAACG -> GCTGTCCATTGTAAAAACGA
AGCACAGAGTGTCCTAATTG -> GCACAGAGTGTCCTAATTGT
CATTCCGAGGACGGGTTTGA -> ATTCCGAGGACGGGTTTGAA
CCGGAGTATGCAATACCGTT -> CGGAGTATGCAATACCGTTT
CAACATTTACTATAATCGGC -> AACATTTACTATAATCGGCT
CGCGGACACATTCTTGAGAC -> GCGGACACATTCTTGAGACT
CCGGTTGACCTTCCCCAATC -> CGGTTGACCTTCCCCAATCT
GCCTGACCCTTCACTGCGTA -> CCTGACCCTTCACTGCGTAT
TATGTGACCAGGTTGCCGAT -> ATGTGACCAGGTTGCCGATT
GTGACCAGGTTGCCGATTAG -> TGACCAGGTTGCCGATTAGG
GTCGGGCCAAGAAGACCAAC -> TCGGGCCAAGAAGACCAACC
GGTGCGTGTCTACGACTGGG -> GTGCGTGTCTACGACTGGGA
TGTCTAGAAACTTGGAGCCG -> GTCTAGAAACTTGGAGCCGT
CCTCTGGAATTGTTGTTAAA -> CTCTGGAATTGTTGTTAAAT
TCTAGGCAGTATATAACTTC -> CTAGGCAGTATATAACTTCC
TTTAGACATTGCCCAAATTG -> TTAGACATTGCCCAAATTGT
ACCCCGTAACATGTGCTGAT -> CCCCGTAACATGTGCTGATG
AATTGTCTAGAAACTTGGAG -> ATTGTCTAGAAACTTGGAGC
CGGGTTATATTGCACGTGCG -> GGGTTATATTGCACGTGCGT
CGCTGTCTAACGTCGGGAGT -> GCTGTCTAACGTCGGGAGTT
CGCTGGGGCATCCGGAGTAT -> GCTGGGGCATCCGGAGTATG
GTCACAGGAGCTTCGGTCTG -> TCACAGGAGCTTCGGTCTGA
ACATAAAACCTGGCATTCCG -> CATAAAACCTGGCATTCCGA
CGACTGGGAGACACGAGCCT -> GACTGGGAGACACGAGCCTG
ACCGTTTACGTGTATCCGAC -> CCGTTTACGTGTATCCGACT
GCTGTTGGAGTGATACACAC -> CTGTTGGAGTGATACACACT
GGACTGACCCACCTGTGCGC -> GACTGACCCACCTGTGCGCT
GCACTGCAAGGTACGCGACT -> CACTGCAAGGTACGCGACTG
GGATAATACCTGAGTGAATG -> GATAATACCTGAGTGAATGG
TCTACGACTGGGAGACACGA -> CTACGACTGGGAGACACGAG
TGCCCAAATTGTCTAGAAAC -> GCCCAAATTGTCTAGAAACT
GACCCCGTAACATGTGCTGA -> ACCCCGTAACATGTGCTGAT
AGCAGCGGCTAGAGTTCGGC -> GCAGCGGCTAGAGTTCGGCA
TGCACGTGCGTTCGCCTTCG -> GCACGTGCGTTCGCCTTCGG
ATTCTTGAGACTACGGGGTC -> TTCTTGAGACTACGGGGTCT
AGTTCTCTCCATCTTAACAT -> GTTCTCTCCATCTTAACATA
GAGATGGTGTGGGCCCGTGC -> AGATGGTGTGGGCCCGTGCG
TTACTATAATCGGCTGTCCA -> TACTATAATCGGCTGTCCAT
TGTAAAAACGAGGCATGGAC -> GTAAAAACGAGGCATGGACA
CAGCGGCTAGAGTTCGGCAT -> AGCGGCTAGAGTTCGGCATT
CGTCAGCATCAGGTCGGCTA -> GTCAGCATCAGGTCGGCTAC
GGTTGACCTTCCCCAATCTA -> GTTGACCTTCCCCAATCTAG
TTCCCCAATCTAGGCAGTAT -> TCCCCAATCTAGGCAGTATA
GTCTAGAAACTTGGAGCCGT -> TCTAGAAACTTGGAGCCGTG
GAGTTGATACCAACATTTAC -> AGTTGATACCAACATTTACT
ATACCGTTTACGTGTATCCG -> TACCGTTTACGTGTATCCGA
CGTTCGCCTTCGGGACTGAC -> GTTCGCCTTCGGGACTGACC
TGCGTGTCTACGACTGGGAG -> GCGTGTCTACGACTGGGAGA
GATACACACTTCCGCGCTCT -> ATACACACTTCCGCGCTCTG
GTCGGCTACGCTCCCGGTGA -> TCGGCTACGCTCCCGGTGAT
CCACGAGTTCTCTCCATCTT -> CACGAGTTCTCTCCATCTTA
CTCGCTGTCTAACGTCGGGA -> TCGCTGTCTAACGTCGGGAG
AATCCGGTTGACCTTCCCCA -> ATCCGGTTGACCTTCCCCAA
AGCGGCTAGAGTTCGGCATT -> GCGGCTAGAGTTCGGCATTT
AGTGATACACACTTCCGCGC -> GTGATACACACTTCCGCGCT
GAGTATCAGCATACCTCGGC -> AGTATCAGCATACCTCGGCC
GCTACCTCGCTGTCTAACGT -> CTACCTCGCTGTCTAACGTC
TAGAAACTTGGAGCCGTGGC -> AGAAACTTGGAGCCGTGGCT
TAGGCTACTTTAGACATTGC -> AGGCTACTTTAGACATTGCC
ACTACGGGGTCTGGATAATA -> CTACGGGGTCTGGATAATAC
GAGAGATGGTGTGGGCCCGT -> AGAGATGGTGTGGGCCCGTG
GACGGGTTTGAACTGAGTCG -> ACGGGTTTGAACTGAGTCGG
GTTAAATTTAGCACAGAGTG -> TTAAATTTAGCACAGAGTGT
TAAGTCTCATGGTCGGCTGT -> AAGTCTCATGGTCGGCTGTA
TGCGCTGTTGGAGTGATACA -> GCGCTGTTGGAGTGATACAC
GCTTACCAGGGAGTATCAGC -> CTTACCAGGGAGTATCAGCA
CGAGACGCCTGGGTCGATCG -> GAGACGCCTGGGTCGATCGT
AAATATGTGACCAGGTTGCC -> AATATGTGACCAGGTTGCCG
CTGCGCTGTTGGAGTGATAC -> TGCGCTGTTGGAGTGATACA
CGTCGGGAGTTGATACCAAC -> GTCGGGAGTTGATACCAACA
TCACAGGAGCTTCGGTCTGA -> CACAGGAGCTTCGGTCTGAG
CACCTGTGCGCTCTTCACCG -> ACCTGTGCGCTCTTCACCGG
TGTTAAATTTAGCACAGAGT -> GTTAAATTTAGCACAGAGTG
ATGTGCTGATGTTGTGGCTT -> TGTGCTGATGTTGTGGCTTA
CGACTCCGACCTGTGTTACA -> GACTCCGACCTGTGTTACAC
AATTGTTGTTAAATTTAGCA -> ATTGTTGTTAAATTTAGCAC
TGGCTTACCAGGGAGTATCA -> GGCTTACCAGGGAGTATCAG
ATATGAGCCTCAGAAGACTT -> TATGAGCCTCAGAAGACTTA
ATCGGCTGTCCATTGTAAAA -> TCGGCTGTCCATTGTAAAAA
TCACCACGAGTTCTCTCCAT -> CACCACGAGTTCTCTCCATC
TATCCGACTCCGACCTGTGT -> ATCCGACTCCGACCTGTGTT
CGAGGCATGGACACCCGGCG -> GAGGCATGGACACCCGGCGC
TACACACTTCCGCGCTCTGA -> ACACACTTCCGCGCTCTGAG
CTGCAAGGTACGCGACTGTA -> TGCAAGGTACGCGACTGTAA
TCCATCTTAACATAAAACCT -> CCATCTTAACATAAAACCTG
GCGCTTAAGAAGGTCCGATG -> CGCTTAAGAAGGTCCGATGA
CCAAGAAGACCAACCAAGAC -> CAAGAAGACCAACCAAGACC
TTGGATCAGCAGCGGCTAGA -> TGGATCAGCAGCGGCTAGAG
GTGTCCTAATTGTAAATATG -> TGTCCTAATTGTAAATATGT
TACGCTCCCGGTGATTTAAT -> ACGCTCCCGGTGATTTAATC
GTCTAACGTCGGGAGTTGAT -> TCTAACGTCGGGAGTTGATA
ATCAGGTCGGCTACGCTCCC -> TCAGGTCGGCTACGCTCCCG
ACGAGTTCTCTCCATCTTAA -> CGAGTTCTCTCCATCTTAAC
ATGAGCCTCAGAAGACTTAA -> TGAGCCTCAGAAGACTTAAT
TGTTGGAGTGATACACACTT -> GTTGGAGTGATACACACTTC
TGCCCACTGCTATTGGATCA -> GCCCACTGCTATTGGATCAG
CCATCACCACGAGTTCTCTC -> CATCACCACGAGTTCTCTCC
ATGAGAGATGGTGTGGGCCC -> TGAGAGATGGTGTGGGCCCG
TACTTTAGACATTGCCCAAA -> ACTTTAGACATTGCCCAAAT
ACGAGGCATGGACACCCGGC -> CGAGGCATGGACACCCGGCG
TGCACTGCAAGGTACGCGAC -> GCACTGCAAGGTACGCGACT
GAGCCGTGGCTGCGAGACGC -> AGCCGTGGCTGCGAGACGCC
GTTGACACAGATGCACTGCA -> TTGACACAGATGCACTGCAA
ACTCCGACCTGTGTTACACT -> CTCCGACCTGTGTTACACTG
TGATACACACTTCCGCGCTC -> GATACACACTTCCGCGCTCT
AGAAGACTTAATACCACTCT -> GAAGACTTAATACCACTCTG
ACACACTTCCGCGCTCTGAG -> CACACTTCCGCGCTCTGAGC
CGGACACATTCTTGAGACTA -> GGACACATTCTTGAGACTAC
GCGCATACGCTATCTACACG -> CGCATACGCTATCTACACGC
TTGCACGTGCGTTCGCCTTC -> TGCACGTGCGTTCGCCTTCG
GCTCCCGGTGATTTAATCCG -> CTCCCGGTGATTTAATCCGG
TGACCAGGTTGCCGATTAGG -> GACCAGGTTGCCGATTAGGT
CCTGTGTTACACTGCGCTGT -> CTGTGTTACACTGCGCTGTT
GGTGAAACAGCGCATACGCT -> GTGAAACAGCGCATACGCTA
TCGGGCCAAGAAGACCAACC -> CGGGCCAAGAAGACCAACCA
CGTGCGTTCGCCTTCGGGAC -> GTGCGTTCGCCTTCGGGACT
CCCACCTGTGCGCTCTTCAC -> CCACCTGTGCGCTCTTCACC
TAGGTCCGCGTCAGCATCAG -> AGGTCCGCGTCAGCATCAGG
TTCCAAGTTGACACAGATGC -> TCCAAGTTGACACAGATGCA
GGAGTGATACACACTTCCGC -> GAGTGATACACACTTCCGCG
ACTGCTATTGGATCAGCAGC -> CTGCTATTGGATCAGCAGCG
AAGACCCCGTAACATGTGCT -> AGACCCCGTAACATGTGCTG
ACACTGCGCTGTTGGAGTGA -> CACTGCGCTGTTGGAGTGAT
GCCTCCGTCACAGGAGCTTC -> CCTCCGTCACAGGAGCTTCG
TACCGTTTACGTGTATCCGA -> ACCGTTTACGTGTATCCGAC
AACTTGGAGCCGTGGCTGCG -> ACTTGGAGCCGTGGCTGCGA
GACTACGGGGTCTGGATAAT -> ACTACGGGGTCTGGATAATA
CGGGCCAAGAAGACCAACCA -> GGGCCAAGAAGACCAACCAA
ATACCACTCTGGTGCGTGTC -> TACCACTCTGGTGCGTGTCT
GGTTAGGCCGTGTCGGGCCA -> GTTAGGCCGTGTCGGGCCAA
GGACGGGTTTGAACTGAGTC -> GACGGGTTTGAACTGAGTCG
GGGAGTATCAGCATACCTCG -> GGAGTATCAGCATACCTCGG
CATCAGGTCGGCTACGCTCC -> ATCAGGTCGGCTACGCTCCC
CCGTGGCTGCGAGACGCCTG -> CGTGGCTGCGAGACGCCTGG
GTGGTTAGGCCGTGTCGGGC -> TGGTTAGGCCGTGTCGGGCC
CGTTTACGTGTATCCGACTC -> GTTTACGTGTATCCGACTCC
GCTTAAGAAGGTCCGATGAG -> CTTAAGAAGGTCCGATGAGA
GATTTAATCCGGTTGACCTT -> ATTTAATCCGGTTGACCTTC
ACTTGGAGCCGTGGCTGCGA -> CTTGGAGCCGTGGCTGCGAG
GCATGGACACCCGGCGCGCC -> CATGGACACCCGGCGCGCCT
CTCTCCATCTTAACATAAAA -> TCTCCATCTTAACATAAAAC
GCGCCTCCGTCACAGGAGCT -> CGCCTCCGTCACAGGAGCTT
TTTACGTGTATCCGACTCCG -> TTACGTGTATCCGACTCCGA
ACCGGCGCGGACACATTCTT -> CCGGCGCGGACACATTCTTG
GGTCTGAGCGCTTAAGAAGG -> GTCTGAGCGCTTAAGAAGGT
TTCCGCGCTCTGAGCTACCT -> TCCGCGCTCTGAGCTACCTC
AGCATCAGGTCGGCTACGCT -> GCATCAGGTCGGCTACGCTC
GGTACGCGACTGTAAGTCTC -> GTACGCGACTGTAAGTCTCA
CCAGGTTGCCGATTAGGTCC -> CAGGTTGCCGATTAGGTCCG
AGGACGGGTTTGAACTGAGT -> GGACGGGTTTGAACTGAGTC
CTACCTCGCTGTCTAACGTC -> TACCTCGCTGTCTAACGTCG
CTAGAAACTTGGAGCCGTGG -> TAGAAACTTGGAGCCGTGGC
GGACACATTCTTGAGACTAC -> GACACATTCTTGAGACTACG
CGTGAGGTGAAACAGCGCAT -> GTGAGGTGAAACAGCGCATA
TGCTGATGTTGTGGCTTACC -> GCTGATGTTGTGGCTTACCA
GATCGTGAGGTGAAACAGCG -> ATCGTGAGGTGAAACAGCGC
TAATTGTAAATATGTGACCA -> AATTGTAAATATGTGACCAG
CACGAGTTCTCTCCATCTTA -> ACGAGTTCTCTCCATCTTAA
TATCTACACGCGCTGGGGCA -> ATCTACACGCGCTGGGGCAT
CGGCCTCTGGAATTGTTGTT -> GGCCTCTGGAATTGTTGTTA
CACTCTGGTGCGTGTCTACG -> ACTCTGGTGCGTGTCTACGA
TATAGGGGGTCTTGCCCACT -> ATAGGGGGTCTTGCCCACTG
GGTCTTGCCCACTGCTATTG -> GTCTTGCCCACTGCTATTGG
CGCCATCACCACGAGTTCTC -> GCCATCACCACGAGTTCTCT
GCGGACACATTCTTGAGACT -> CGGACACATTCTTGAGACTA
GGCATTTCGCCATCACCACG -> GCATTTCGCCATCACCACGA
CCTTCCCCAATCTAGGCAGT -> CTTCCCCAATCTAGGCAGTA
GTATATAACTTCCAAGTTGA -> TATATAACTTCCAAGTTGAC
CCCAATCTAGGCAGTATATA -> CCAATCTAGGCAGTATATAA
CGCTCTTCACCGGCGCGGAC -> GCTCTTCACCGGCGCGGACA
CGAGCCTGACCCTTCACTGC -> GAGCCTGACCCTTCACTGCG
ATAATACCTGAGTGAATGGA -> TAATACCTGAGTGAATGGAC
TGAGCTACCTCGCTGTCTAA -> GAGCTACCTCGCTGTCTAAC
TGGATAATACCTGAGTGAAT -> GGATAATACCTGAGTGAATG
GGGAGACACGAGCCTGACCC -> GGAGACACGAGCCTGACCCT
CTTCACTGCGTATCCTGCCT -> TTCACTGCGTATCCTGCCTA
CTAATTGTAAATATGTGACC -> TAATTGTAAATATGTGACCA
TTGGAGCCGTGGCTGCGAGA -> TGGAGCCGTGGCTGCGAGAC
CCGTCACAGGAGCTTCGGTC -> CGTCACAGGAGCTTCGGTCT
GTTCGCCTTCGGGACTGACC -> TTCGCCTTCGGGACTGACCC
CTTGAGACTACGGGGTCTGG -> TTGAGACTACGGGGTCTGGA
CTCCATCTTAACATAAAACC -> TCCATCTTAACATAAAACCT
GGGGTCTGGATAATACCTGA -> GGGTCTGGATAATACCTGAG
TGTGTTACACTGCGCTGTTG -> GTGTTACACTGCGCTGTTGG
CATAAAACCTGGCATTCCGA -> ATAAAACCTGGCATTCCGAG
ATGTGACCAGGTTGCCGATT -> TGTGACCAGGTTGCCGATTA
GGCTTACCAGGGAGTATCAG -> GCTTACCAGGGAGTATCAGC
CAGGTCGGCTACGCTCCCGG -> AGGTCGGCTACGCTCCCGGT
CATTGTAAAAACGAGGCATG -> ATTGTAAAAACGAGGCATGG
ACTATAATCGGCTGTCCATT -> CTATAATCGGCTGTCCATTG
CTCTGGAATTGTTGTTAAAT -> TCTGGAATTGTTGTTAAATT
GGGGGTCTTGCCCACTGCTA -> GGGGTCTTGCCCACTGCTAT
TCTTAACATAAAACCTGGCA -> CTTAACATAAAACCTGGCAT
AGTATATAACTTCCAAGTTG -> GTATATAACTTCCAAGTTGA
TCTGGATAATACCTGAGTGA -> CTGGATAATACCTGAGTGAA
TCCGTCACAGGAGCTTCGGT -> CCGTCACAGGAGCTTCGGTC
CGTGTCGGGCCAAGAAGACC -> GTGTCGGGCCAAGAAGACCA
GTGAATGGACCGTTCAATCT -> TGAATGGACCGTTCAATCTA
AGGTCCGATGAGAGATGGTG -> GGTCCGATGAGAGATGGTGT
GGCCTCTGGAATTGTTGTTA -> GCCTCTGGAATTGTTGTTAA
AGTATGCAATACCGTTTACG -> GTATGCAATACCGTTTACGT
TAGGGGGTCTTGCCCACTGC -> AGGGGGTCTTGCCCACTGCT
TCAGAAGACTTAATACCACT -> CAGAAGACTTAATACCACTC
GTCTACGACTGGGAGACACG -> TCTACGACTGGGAGACACGA
TAAATATGTGACCAGGTTGC -> AAATATGTGACCAGGTTGCC
ATCGTGAGGTGAAACAGCGC -> TCGTGAGGTGAAACAGCGCA
GGCCGTGTCGGGCCAAGAAG -> GCCGTGTCGGGCCAAGAAGA
CCTCCGTCACAGGAGCTTCG -> CTCCGTCACAGGAGCTTCGG
AGCTACCTCGCTGTCTAACG -> GCTACCTCGCTGTCTAACGT
ACCTCGCTGTCTAACGTCGG -> CCTCGCTGTCTAACGTCGGG
CCCTTCACTGCGTATCCTGC -> CCTTCACTGCGTATCCTGCC
TTTCGCCATCACCACGAGTT -> TTCGCCATCACCACGAGTTC
GCCGTGTCGGGCCAAGAAGA -> CCGTGTCGGGCCAAGAAGAC
GTTAGGCCGTGTCGGGCCAA -> TTAGGCCGTGTCGGGCCAAG
TCCCGGTGATTTAATCCGGT -> CCCGGTGATTTAATCCGGTT
ACGGGTTTGAACTGAGTCGG -> CGGGTTTGAACTGAGTCGGG
TCAGCAGCGGCTAGAGTTCG -> CAGCAGCGGCTAGAGTTCGG
ATAAAACCTGGCATTCCGAG -> TAAAACCTGGCATTCCGAGG
TGACCCTTCACTGCGTATCC -> GACCCTTCACTGCGTATCCT
AGCCTCAGAAGACTTAATAC -> GCCTCAGAAGACTTAATACC
CGCTCCCGGTGATTTAATCC -> GCTCCCGGTGATTTAATCCG
GTAAATATGTGACCAGGTTG -> TAAATATGTGACCAGGTTGC
ACGCTCCCGGTGATTTAATC -> CGCTCCCGGTGATTTAATCC
GACACCCGGCGCGCCTCCGT -> ACACCCGGCGCGCCTCCGTC
CACGTGCGTTCGCCTTCGGG -> ACGTGCGTTCGCCTTCGGGA
GTCTGGATAATACCTGAGTG -> TCTGGATAATACCTGAGTGA
AGGCCGTGTCGGGCCAAGAA -> GGCCGTGTCGGGCCAAGAAG
TAACGTCGGGAGTTGATACC -> AACGTCGGGAGTTGATACCA
AAATTTAGCACAGAGTGTCC -> AATTTAGCACAGAGTGTCCT
TATTGCACGTGCGTTCGCCT -> ATTGCACGTGCGTTCGCCTT
GAGACGCCTGGGTCGATCGT -> AGACGCCTGGGTCGATCGTG
TACGCTATCTACACGCGCTG -> ACGCTATCTACACGCGCTGG
ACACAGATGCACTGCAAGGT -> CACAGATGCACTGCAAGGTA
CACCACGAGTTCTCTCCATC -> ACCACGAGTTCTCTCCATCT
AGGTGAAACAGCGCATACGC -> GGTGAAACAGCGCATACGCT
CTGAGCGCTTAAGAAGGTCC -> TGAGCGCTTAAGAAGGTCCG
GTGGCTTACCAGGGAGTATC -> TGGCTTACCAGGGAGTATCA
ACCAGGGAGTATCAGCATAC -> CCAGGGAGTATCAGCATACC
TCTCATGGTCGGCTGTATAG -> CTCATGGTCGGCTGTATAGG
CGCATACGCTATCTACACGC -> GCATACGCTATCTACACGCG
TGGTCGGCTGTATAGGGGGT -> GGTCGGCTGTATAGGGGGTC
AGGCAGTATATAACTTCCAA -> GGCAGTATATAACTTCCAAG
GAGTTCGGCATTTCGCCATC -> AGTTCGGCATTTCGCCATCA
CTTAACATAAAACCTGGCAT -> TTAACATAAAACCTGGCATT
AACCAAGACCCCGTAACATG -> ACCAAGACCCCGTAACATGT
CTGACCCTTCACTGCGTATC -> TGACCCTTCACTGCGTATCC
AATCTAGGCAGTATATAACT -> ATCTAGGCAGTATATAACTT
CGTGCGTGGTTAGGCCGTGT -> GTGCGTGGTTAGGCCGTGTC
GCCATCACCACGAGTTCTCT -> CCATCACCACGAGTTCTCTC
AATACCACTCTGGTGCGTGT -> ATACCACTCTGGTGCGTGTC
CCTTCGGGACTGACCCACCT -> CTTCGGGACTGACCCACCTG
ACATTGCCCAAATTGTCTAG -> CATTGCCCAAATTGTCTAGA
CCGATTAGGTCCGCGTCAGC -> CGATTAGGTCCGCGTCAGCA
ACTTAATACCACTCTGGTGC -> CTTAATACCACTCTGGTGCG
CTGGATAATACCTGAGTGAA -> TGGATAATACCTGAGTGAAT
GCCGATTAGGTCCGCGTCAG -> CCGATTAGGTCCGCGTCAGC
GAGCTACCTCGCTGTCTAAC -> AGCTACCTCGCTGTCTAACG
CTGAGTGAATGGACCGTTCA -> TGAGTGAATGGACCGTTCAA
AGGGAGTATCAGCATACCTC -> GGGAGTATCAGCATACCTCG
GGAGCCGTGGCTGCGAGACG -> GAGCCGTGGCTGCGAGACGC
CAGCATACCTCGGCCTCTGG -> AGCATACCTCGGCCTCTGGA
TTCACTGCGTATCCTGCCTA -> TCACTGCGTATCCTGCCTAT
TAAAAACGAGGCATGGACAC -> AAAAACGAGGCATGGACACC
GCGTATCCTGCCTATAGGCT -> CGTATCCTGCCTATAGGCTA
AGTTGATACCAACATTTACT -> GTTGATACCAACATTTACTA
TTCTCTCCATCTTAACATAA -> TCTCTCCATCTTAACATAAA
GTGCGTGTCTACGACTGGGA -> TGCGTGTCTACGACTGGGAG
GTATCCTGCCTATAGGCTAC -> TATCCTGCCTATAGGCTACT
CAGGAGCTTCGGTCTGAGCG -> AGGAGCTTCGGTCTGAGCGC
CCATCTTAACATAAAACCTG -> CATCTTAACATAAAACCTGG
GGGGTCTTGCCCACTGCTAT -> GGGTCTTGCCCACTGCTATT
CACAGAGTGTCCTAATTGTA -> ACAGAGTGTCCTAATTGTAA
CTGGGAGACACGAGCCTGAC -> TGGGAGACACGAGCCTGACC
CTCGGCCTCTGGAATTGTTG -> TCGGCCTCTGGAATTGTTGT
GACCCTTCACTGCGTATCCT -> ACCCTTCACTGCGTATCCTG
TTGACCTTCCCCAATCTAGG -> TGACCTTCCCCAATCTAGGC
ACCCGGCGCGCCTCCGTCAC -> CCCGGCGCGCCTCCGTCACA
TACCTCGCTGTCTAACGTCG -> ACCTCGCTGTCTAACGTCGG
GTGAAACAGCGCATACGCTA -> TGAAACAGCGCATACGCTAT
AAAAACGAGGCATGGACACC -> AAAACGAGGCATGGACACCC
GGAGTATGCAATACCGTTTA -> GAGTATGCAATACCGTTTAC
TGTATAGGGGGTCTTGCCCA -> GTATAGGGGGTCTTGCCCAC
TCCGCGTCAGCATCAGGTCG -> CCGCGTCAGCATCAGGTCGG
TATATAACTTCCAAGTTGAC -> ATATAACTTCCAAGTTGACA
AAGAAGGTCCGATGAGAGAT -> AGAAGGTCCGATGAGAGATG
CCTCGGCCTCTGGAATTGTT -> CTCGGCCTCTGGAATTGTTG
GTTTACGTGTATCCGACTCC -> TTTACGTGTATCCGACTCCG
GTAAGTCTCATGGTCGGCTG -> TAAGTCTCATGGTCGGCTGT
TGCGTATCCTGCCTATAGGC -> GCGTATCCTGCCTATAGGCT
GTCGGGAGTTGATACCAACA -> TCGGGAGTTGATACCAACAT
ATCAGCATACCTCGGCCTCT -> TCAGCATACCTCGGCCTCTG
GGAGACACGAGCCTGACCCT -> GAGACACGAGCCTGACCCTT
TCGGGACTGACCCACCTGTG -> CGGGACTGACCCACCTGTGC
TACCTCGGCCTCTGGAATTG -> ACCTCGGCCTCTGGAATTGT
CCCGGTGATTTAATCCGGTT -> CCGGTGATTTAATCCGGTTG
GACTGGGAGACACGAGCCTG -> ACTGGGAGACACGAGCCTGA
CAGCGCATACGCTATCTACA -> AGCGCATACGCTATCTACAC
GCTGTCCATTGTAAAAACGA -> CTGTCCATTGTAAAAACGAG
GGCATTCCGAGGACGGGTTT -> GCATTCCGAGGACGGGTTTG
TCCGAGGACGGGTTTGAACT -> CCGAGGACGGGTTTGAACTG
CACAGGAGCTTCGGTCTGAG -> ACAGGAGCTTCGGTCTGAGC
TGGTGTGGGCCCGTGCGTGG -> GGTGTGGGCCCGTGCGTGGT
GTATCCGACTCCGACCTGTG -> TATCCGACTCCGACCTGTGT
GGGTCTGGATAATACCTGAG -> GGTCTGGATAATACCTGAGT
CGGTTGACCTTCCCCAATCT -> GGTTGACCTTCCCCAATCTA
TCTGAGCTACCTCGCTGTCT -> CTGAGCTACCTCGCTGTCTA
TGTTGTGGCTTACCAGGGAG -> GTTGTGGCTTACCAGGGAGT
TATGCAATACCGTTTACGTG -> ATGCAATACCGTTTACGTGT
ATATAACTTCCAAGTTGACA -> TATAACTTCCAAGTTGACAC
AACTTCCAAGTTGACACAGA -> ACTTCCAAGTTGACACAGAT
AGTCGGGTTATATTGCACGT -> GTCGGGTTATATTGCACGTG
ATATTGCACGTGCGTTCGCC -> TATTGCACGTGCGTTCGCCT
ATGCAATACCGTTTACGTGT -> TGCAATACCGTTTACGTGTA
AGACCCCGTAACATGTGCTG -> GACCCCGTAACATGTGCTGA
AGTGTCCTAATTGTAAATAT -> GTGTCCTAATTGTAAATATG
ACTTTAGACATTGCCCAAAT -> CTTTAGACATTGCCCAAATT
CGCGCCTCCGTCACAGGAGC -> GCGCCTCCGTCACAGGAGCT
GGCTGCGAGACGCCTGGGTC -> GCTGCGAGACGCCTGGGTCG
TTGTAAATATGTGACCAGGT -> TGTAAATATGTGACCAGGTT
GTATCAGCATACCTCGGCCT -> TATCAGCATACCTCGGCCTC
CTATAGGCTACTTTAGACAT -> TATAGGCTACTTTAGACATT
GCTCTTCACCGGCGCGGACA -> CTCTTCACCGGCGCGGACAC
AGTGAATGGACCGTTCAATC -> GTGAATGGACCGTTCAATCT
CATGGACACCCGGCGCGCCT -> ATGGACACCCGGCGCGCCTC
AACTGAGTCGGGTTATATTG -> ACTGAGTCGGGTTATATTGC
AACGTCGGGAGTTGATACCA -> ACGTCGGGAGTTGATACCAA
TTTAGCACAGAGTGTCCTAA -> TTAGCACAGAGTGTCCTAAT
GATGCACTGCAAGGTACGCG -> ATGCACTGCAAGGTACGCGA
GGGCCAAGAAGACCAACCAA -> GGCCAAGAAGACCAACCAAG
CGGCGCGGACACATTCTTGA -> GGCGCGGACACATTCTTGAG
ACAGAGTGTCCTAATTGTAA -> CAGAGTGTCCTAATTGTAAA
CGTGGCTGCGAGACGCCTGG -> GTGGCTGCGAGACGCCTGGG
AAGTTGACACAGATGCACTG -> AGTTGACACAGATGCACTGC
ACTGTAAGTCTCATGGTCGG -> CTGTAAGTCTCATGGTCGGC
TCCTGCCTATAGGCTACTTT -> CCTGCCTATAGGCTACTTTA
CTGTATAGGGGGTCTTGCCC -> TGTATAGGGGGTCTTGCCCA
ATACCTGAGTGAATGGACCG -> TACCTGAGTGAATGGACCGT
ATCTAGGCAGTATATAACTT -> TCTAGGCAGTATATAACTTC
GTCAGCATCAGGTCGGCTAC -> TCAGCATCAGGTCGGCTACG
GGCGCGGACACATTCTTGAG -> GCGCGGACACATTCTTGAGA
CATGGTCGGCTGTATAGGGG -> ATGGTCGGCTGTATAGGGGG
CAGTATATAACTTCCAAGTT -> AGTATATAACTTCCAAGTTG
CGTGTATCCGACTCCGACCT -> GTGTATCCGACTCCGACCTG
CACATTCTTGAGACTACGGG -> ACATTCTTGAGACTACGGGG
GTAACATGTGCTGATGTTGT -> TAACATGTGCTGATGTTGTG
CATCCGGAGTATGCAATACC -> ATCCGGAGTATGCAATACCG
ATGTTGTGGCTTACCAGGGA -> TGTTGTGGCTTACCAGGGAG
AAACGAGGCATGGACACCCG -> AACGAGGCATGGACACCCGG
GAGGTGAAACAGCGCATACG -> AGGTGAAACAGCGCATACGC
TTAACATAAAACCTGGCATT -> TAACATAAAACCTGGCATTC
GGTTTGAACTGAGTCGGGTT -> GTTTGAACTGAGTCGGGTTA
TATGAGCCTCAGAAGACTTA -> ATGAGCCTCAGAAGACTTAA
AGATGCACTGCAAGGTACGC -> GATGCACTGCAAGGTACGCG
CGGCGCGCCTCCGTCACAGG -> GGCGCGCCTCCGTCACAGGA
TCCCCAATCTAGGCAGTATA -> CCCCAATCTAGGCAGTATAT
CTTCCCCAATCTAGGCAGTA -> TTCCCCAATCTAGGCAGTAT
CTCCGTCACAGGAGCTTCGG -> TCCGTCACAGGAGCTTCGGT
CGCGCTCTGAGCTACCTCGC -> GCGCTCTGAGCTACCTCGCT
CGATTAGGTCCGCGTCAGCA -> GATTAGGTCCGCGTCAGCAT
AACATGTGCTGATGTTGTGG -> ACATGTGCTGATGTTGTGGC
TTAAGAAGGTCCGATGAGAG -> TAAGAAGGTCCGATGAGAGA
TTCTTGAGACTACGGGGTCT -> TCTTGAGACTACGGGGTCTG
TTTACTATAATCGGCTGTCC -> TTACTATAATCGGCTGTCCA
CACTGCAAGGTACGCGACTG -> ACTGCAAGGTACGCGACTGT
ATCTACACGCGCTGGGGCAT -> TCTACACGCGCTGGGGCATC
GGGGCATCCGGAGTATGCAA -> GGGCATCCGGAGTATGCAAT
GCAATACCGTTTACGTGTAT -> CAATACCGTTTACGTGTATC
CTGTCTAACGTCGGGAGTTG -> TGTCTAACGTCGGGAGTTGA
CATACCTCGGCCTCTGGAAT -> ATACCTCGGCCTCTGGAATT
GTTCTCTCCATCTTAACATA -> TTCTCTCCATCTTAACATAA
ATCAGCAGCGGCTAGAGTTC -> TCAGCAGCGGCTAGAGTTCG
TTGACACAGATGCACTGCAA -> TGACACAGATGCACTGCAAG
GTGCGCTCTTCACCGGCGCG -> TGCGCTCTTCACCGGCGCGG
CGACTGTAAGTCTCATGGTC -> GACTGTAAGTCTCATGGTCG
CGCCTTCGGGACTGACCCAC -> GCCTTCGGGACTGACCCACC
ACCCTTCACTGCGTATCCTG -> CCCTTCACTGCGTATCCTGC
TGGCTGCGAGACGCCTGGGT -> GGCTGCGAGACGCCTGGGTC
TTGAGACTACGGGGTCTGGA -> TGAGACTACGGGGTCTGGAT
GACTGTAAGTCTCATGGTCG -> ACTGTAAGTCTCATGGTCGG
TTAGGTCCGCGTCAGCATCA -> TAGGTCCGCGTCAGCATCAG
CTGGAATTGTTGTTAAATTT -> TGGAATTGTTGTTAAATTTA
ACGTGCGTTCGCCTTCGGGA -> CGTGCGTTCGCCTTCGGGAC
GCATACGCTATCTACACGCG -> CATACGCTATCTACACGCGC
GAGTGAATGGACCGTTCAAT -> AGTGAATGGACCGTTCAATC
ATAGGGGGTCTTGCCCACTG -> TAGGGGGTCTTGCCCACTGC
AGGCATGGACACCCGGCGCG -> GGCATGGACACCCGGCGCGC
CTACTTTAGACATTGCCCAA -> TACTTTAGACATTGCCCAAA
AAGACTTAATACCACTCTGG -> AGACTTAATACCACTCTGGT
GCACGTGCGTTCGCCTTCGG -> CACGTGCGTTCGCCTTCGGG
ACGCGCTGGGGCATCCGGAG -> CGCGCTGGGGCATCCGGAGT
ACTGCGCTGTTGGAGTGATA -> CTGCGCTGTTGGAGTGATAC
GGAGCTTCGGTCTGAGCGCT -> GAGCTTCGGTCTGAGCGCTT
TGAACTGAGTCGGGTTATAT -> GAACTGAGTCGGGTTATATT
AGGTACGCGACTGTAAGTCT -> GGTACGCGACTGTAAGTCTC
TCGGCCTCTGGAATTGTTGT -> CGGCCTCTGGAATTGTTGTT
GTGCGTTCGCCTTCGGGACT -> TGCGTTCGCCTTCGGGACTG
GTGTCGGGCCAAGAAGACCA -> TGTCGGGCCAAGAAGACCAA
CCACTCTGGTGCGTGTCTAC -> CACTCTGGTGCGTGTCTACG
GTTGCCGATTAGGTCCGCGT -> TTGCCGATTAGGTCCGCGTC
CCTGGGTCGATCGTGAGGTG -> CTGGGTCGATCGTGAGGTGA
AGGTCCGCGTCAGCATCAGG -> GGTCCGCGTCAGCATCAGGT
ATACCTCGGCCTCTGGAATT -> TACCTCGGCCTCTGGAATTG
CACCCGGCGCGCCTCCGTCA -> ACCCGGCGCGCCTCCGTCAC
CAAGAAGACCAACCAAGACC -> AAGAAGACCAACCAAGACCC
ACACGCGCTGGGGCATCCGG -> CACGCGCTGGGGCATCCGGA
TTAATACCACTCTGGTGCGT -> TAATACCACTCTGGTGCGTG
GCGCTCTTCACCGGCGCGGA -> CGCTCTTCACCGGCGCGGAC
TGAGCCTCAGAAGACTTAAT -> GAGCCTCAGAAGACTTAATA
TACCTGAGTGAATGGACCGT -> ACCTGAGTGAATGGACCGTT
CCGTGTCGGGCCAAGAAGAC -> CGTGTCGGGCCAAGAAGACC
TGTCTAACGTCGGGAGTTGA -> GTCTAACGTCGGGAGTTGAT
CGGCTGTATAGGGGGTCTTG -> GGCTGTATAGGGGGTCTTGC
CCAACATTTACTATAATCGG -> CAACATTTACTATAATCGGC
CGCGCTGGGGCATCCGGAGT -> GCGCTGGGGCATCCGGAGTA
TTCGCCATCACCACGAGTTC -> TCGCCATCACCACGAGTTCT
ATACGCTATCTACACGCGCT -> TACGCTATCTACACGCGCTG
TATCAGCATACCTCGGCCTC -> ATCAGCATACCTCGGCCTCT
TGAGACTACGGGGTCTGGAT -> GAGACTACGGGGTCTGGATA
ACACATTCTTGAGACTACGG -> CACATTCTTGAGACTACGGG
AATACCGTTTACGTGTATCC -> ATACCGTTTACGTGTATCCG
GATACCAACATTTACTATAA -> ATACCAACATTTACTATAAT
CCCCAATCTAGGCAGTATAT -> CCCAATCTAGGCAGTATATA
CGTATCCTGCCTATAGGCTA -> GTATCCTGCCTATAGGCTAC
TTCGGGACTGACCCACCTGT -> TCGGGACTGACCCACCTGTG
TACTATAATCGGCTGTCCAT -> ACTATAATCGGCTGTCCATT
TTCGGCATTTCGCCATCACC -> TCGGCATTTCGCCATCACCA
TCTACACGCGCTGGGGCATC -> CTACACGCGCTGGGGCATCC
ACAGATGCACTGCAAGGTAC -> CAGATGCACTGCAAGGTACG
TCGGGTTATATTGCACGTGC -> CGGGTTATATTGCACGTGCG
ACACGAGCCTGACCCTTCAC -> CACGAGCCTGACCCTTCACT
CATTCTTGAGACTACGGGGT -> ATTCTTGAGACTACGGGGTC
GTGTGGGCCCGTGCGTGGTT -> TGTGGGCCCGTGCGTGGTTA
TGAGGTGAAACAGCGCATAC -> GAGGTGAAACAGCGCATACG
AGGCTACTTTAGACATTGCC -> GGCTACTTTAGACATTGCCC
CTGTAAGTCTCATGGTCGGC -> TGTAAGTCTCATGGTCGGCT
ACATTCTTGAGACTACGGGG -> CATTCTTGAGACTACGGGGT
AATATGTGACCAGGTTGCCG -> ATATGTGACCAGGTTGCCGA
CTTTAGACATTGCCCAAATT -> TTTAGACATTGCCCAAATTG
CTGCGTATCCTGCCTATAGG -> TGCGTATCCTGCCTATAGGC
CCTTCACTGCGTATCCTGCC -> CTTCACTGCGTATCCTGCCT
GGGTCTTGCCCACTGCTATT -> GGTCTTGCCCACTGCTATTG
TGCCTATAGGCTACTTTAGA -> GCCTATAGGCTACTTTAGAC
ACGCCTGGGTCGATCGTGAG -> CGCCTGGGTCGATCGTGAGG
TGAATGGACCGTTCAATCTA -> GAATGGACCGTTCAATCTAG
CCTCGCTGTCTAACGTCGGG -> CTCGCTGTCTAACGTCGGGA
CAGATGCACTGCAAGGTACG -> AGATGCACTGCAAGGTACGC
GTCCATTGTAAAAACGAGGC -> TCCATTGTAAAAACGAGGCA
CTTCGGGACTGACCCACCTG -> TTCGGGACTGACCCACCTGT
GCATATGAGCCTCAGAAGAC -> CATATGAGCCTCAGAAGACT
ATACACACTTCCGCGCTCTG -> TACACACTTCCGCGCTCTGA
CGCCTGGGTCGATCGTGAGG -> GCCTGGGTCGATCGTGAGGT
TAATACCTGAGTGAATGGAC -> AATACCTGAGTGAATGGACC
CACAGATGCACTGCAAGGTA -> ACAGATGCACTGCAAGGTAC
GATTAGGTCCGCGTCAGCAT -> ATTAGGTCCGCGTCAGCATC
GGGTCGATCGTGAGGTGAAA -> GGTCGATCGTGAGGTGAAAC
TTACGTGTATCCGACTCCGA -> TACGTGTATCCGACTCCGAC
TAGGCAGTATATAACTTCCA -> AGGCAGTATATAACTTCCAA
ACAGCGCATACGCTATCTAC -> CAGCGCATACGCTATCTACA
GATCAGCAGCGGCTAGAGTT -> ATCAGCAGCGGCTAGAGTTC
GCCTTCGGGACTGACCCACC -> CCTTCGGGACTGACCCACCT
TATAATCGGCTGTCCATTGT -> ATAATCGGCTGTCCATTGTA
GTATGCAATACCGTTTACGT -> TATGCAATACCGTTTACGTG
TGCAATACCGTTTACGTGTA -> GCAATACCGTTTACGTGTAT
AATCGGCTGTCCATTGTAAA -> ATCGGCTGTCCATTGTAAAA
CGGTCTGAGCGCTTAAGAAG -> GGTCTGAGCGCTTAAGAAGG
CTATAATCGGCTGTCCATTG -> TATAATCGGCTGTCCATTGT
CCCGTGCGTGGTTAGGCCGT -> CCGTGCGTGGTTAGGCCGTG
TCATGGTCGGCTGTATAGGG -> CATGGTCGGCTGTATAGGGG
TCGGTCTGAGCGCTTAAGAA -> CGGTCTGAGCGCTTAAGAAG
AGGAGCTTCGGTCTGAGCGC -> GGAGCTTCGGTCTGAGCGCT
GCCTCTGGAATTGTTGTTAA -> CCTCTGGAATTGTTGTTAAA
GTCCGCGTCAGCATCAGGTC -> TCCGCGTCAGCATCAGGTCG
CTACGGGGTCTGGATAATAC -> TACGGGGTCTGGATAATACC
AGTTCGGCATTTCGCCATCA -> GTTCGGCATTTCGCCATCAC
ATTTAGCACAGAGTGTCCTA -> TTTAGCACAGAGTGTCCTAA
GCCTCAGAAGACTTAATACC -> CCTCAGAAGACTTAATACCA
GTTGACCTTCCCCAATCTAG -> TTGACCTTCCCCAATCTAGG
CTGTGCGCTCTTCACCGGCG -> TGTGCGCTCTTCACCGGCGC
TAGCACAGAGTGTCCTAATT -> AGCACAGAGTGTCCTAATTG
TCTTCACCGGCGCGGACACA -> CTTCACCGGCGCGGACACAT
CTCTGAGCTACCTCGCTGTC -> TCTGAGCTACCTCGCTGTCT
GAGCCTGACCCTTCACTGCG -> AGCCTGACCCTTCACTGCGT
ACCAACCAAGACCCCGTAAC -> CCAACCAAGACCCCGTAACA
AGAAGACCAACCAAGACCCC -> GAAGACCAACCAAGACCCCG
CACCGGCGCGGACACATTCT -> ACCGGCGCGGACACATTCTT
GTGTCTACGACTGGGAGACA -> TGTCTACGACTGGGAGACAC
TCACTGCGTATCCTGCCTAT -> CACTGCGTATCCTGCCTATA
TAAAACCTGGCATTCCGAGG -> AAAACCTGGCATTCCGAGGA
CCGTAACATGTGCTGATGTT -> CGTAACATGTGCTGATGTTG
GGCTGTATAGGGGGTCTTGC -> GCTGTATAGGGGGTCTTGCC
GGTCCGCGTCAGCATCAGGT -> GTCCGCGTCAGCATCAGGTC
CATCTTAACATAAAACCTGG -> ATCTTAACATAAAACCTGGC
ACTGAGTCGGGTTATATTGC -> CTGAGTCGGGTTATATTGCA
GGCATGGACACCCGGCGCGC -> GCATGGACACCCGGCGCGCC
GACCAACCAAGACCCCGTAA -> ACCAACCAAGACCCCGTAAC
TGCCGATTAGGTCCGCGTCA -> GCCGATTAGGTCCGCGTCAG
AGTTGACACAGATGCACTGC -> GTTGACACAGATGCACTGCA
ATTGGATCAGCAGCGGCTAG -> TTGGATCAGCAGCGGCTAGA
CAGGGAGTATCAGCATACCT -> AGGGAGTATCAGCATACCTC
GCAGTATATAACTTCCAAGT -> CAGTATATAACTTCCAAGTT
